Abandon bỏ, từ bỏ
Abandoned   bị bỏ rơi, bị ruồng bỏ
Ability khả năng, năng lực
Able	có năng lực, có tài
Unable	không có năng lực, không có tài
About	khoảng, về
Above	ở trên, lên trên
Abroad	ở/ra nước ngoài, ngoài trời
Absence	sự vắng mặt
Absent	vắng mặt, nghỉ
Absolute	tuyệt đối, hoàn toàn
Absolutely	tuyệt đối, hoàn toàn
Absorb	thu hút, hấp thu, lôi cuốn
Abuse	lộng hành, lạm dụng
Academic	thuộc học viện,  Đại học
Accent	trọng âm, dấu trọng âm
Accept	chấp nhận, chấp thuận
Acceptable	có thể chấp nhận, chấp thuận
Access	lối, cửa, đường vào
Accident	tai nạn, rủi ro
accidental	tình cờ, bất ngờ
accidentally	tình cờ, ngẫu nhiên
accommodation	sự thích nghi, điều tiết
accompany	đi theo, đi cùng, kèm theo
according to	theo, y theo
account	tài khoản, kế toán
accurate	đúng đắn, chính xác
accurately	đúng đắn, chính xác
accuse	tố cáo, buộc tội, kết tội
achieve	đạt được, dành được
achievement	thành tích, thành tựu
acid	axit
acknowledge	công nhận, thừa nhận
acquire	dành được, đạt được, kiếm được
across	qua, ngang qua
act	hành động, hành vi, cử chỉ, đối xử
action	hành động, hành vi, tác động
take action	hành động
active	tích cực hoạt động, nhanh nhẹn
actor	diễn viên
actual	thực tế, có thật
actually	hiện nay, hiện tại
advertisement	quảng cáo
adapt	tra, lắp vào
add	thêm vào, cộng
addition	tính cộng, phép cộng
in addition (to)	 thêm vào
additional	thêm vào, tăng thêm
address	địa chỉ, đề địa chỉ
adequate	đầy, đầy đủ
adequately	tương xứng, thỏa đáng
adjust	sửa lại cho đúng, điều chỉnh
admiration	sự khâm phục, thán phục
admire	khâm phục, thán phục
admit	nhận vào, cho vào, kết hợp
adopt	nhận làm con nuôi, bố mẹ nuôi
adult	người trưởng thành; trưởng thành
advance	sự tiến bộ, tiến lên
advanced	tiên tiến, tiến bộ
in advance	trước, sớm
advantage	sự thuận lợi, lợi thế
take advantage of		lợi dụng
adventure	sự phiêu lưu, mạo hiểm
advertise	báo cho biết, báo cho biết trước
advertising	sự quảng cáo, nghề quảng cáo
advice	lời khuyên, lời chỉ bảo
advise	khuyên bảo, răn bảo
affair	việc
affect	làm ảnh hưởng, tác động đến
afford	có thể, có đủ điều kiện (làm gì)
afraid	sợ, sợ hãi, hoảng sợ
after	 đằng sau, sau khi
afternoon	buổi chiều
afterwards	sau này, về sau
again	lại, nữa, lần nữa
against	chống lại, phản đối
age	tuổi
aged	già đi (v)
agency	giới, trung gian	
agent	đại lý, tác nhân
aggressive	xâm lược, hung hăng
ago	trước đây
agree	đồng ý, tán thành
agreement	sự đồng ý; hợp đồng
ahead	 trước, về phía trước
aid	 sự giúp đỡ; thêm vào
aim	 sự nhắm (bắn), mục tiêu; nhắm vào
air	không khí, không gian
aircraft	 máy bay, khí cầu
airport	sân bay, phi trường
alarm	báo động, báo nguy
alarming	làm lo sợ, làm hốt hoảng
alcohol	rượu cồn
alcoholic	 rượu; người nghiện rượu
alive	 sống, vẫn còn sống, còn tồn tại
all	tất cả
allow	 cho phép, để cho
all right	 tốt; được
ally	 nước đồng minh; liên kết
allied	 lien minh, đồng minh, thông gia
almost	 hầu như, gần như
alone	 cô đơn, một mình
along	 dọc theo; theo chiều dài
alongside	 sát cạnh, kế bên
aloud	 lớn tiếng, to tiếng
alphabet	 bảng chữ cái; điều cơ bản
alphabetical	 thuộc bảng chứ cái
alphabetically	 theo thứ tự abc
already	 đã, rồi
also	 cũng, cũng vậy,
alter	 thay đổi, biến đổi, sửa đổi
alternative	 sự lựa chọn; lựa chọn
alternatively	 như một sự lựa chọn
although	 mặc dù, dẫu cho
altogether	 hoàn toàn; nói chung
always	 luôn luôn
amaze	 làm ngạc nhiên, làm sửng sốt
amazing	 kinh ngạc, sửng sốt
amazed	 kinh ngạc, sửng sốt
ambition	 hoài bão, khát vọng
ambulance	 xe cứu thương, xe cấp cứu
among	 giữa, ở giữa
amount	số lượng, số nhiều
amuse	 làm cho vui, làm buồn cười
amusing	vui thích
amused	 vui thích
analyse	phân tích
analysis	sự phân tích
ancient	xưa, cổ
and	và
anger n. /'æɳgə/ sự tức giận, sự giận dữ
angle 	 góc
angry 	adj. /'æɳgri/ giận, tức giận
angrily 	 tức giận, giận dữ
animal 	 động vật, thú vật
ankle 	 mắt cá chân
anniversary 	 ngày, lễ kỉ niệm
announce 	 báo, thông báo
annoy 	 chọc tức, quẫy nhiễu
annoying 	 chọc tức, quẫy nhiễu
annoyed 	 bị khó chịu, bực mình
annual 	 hàng năm, từng năm
annually 	 hàng năm, từng năm
another 	 khác
answer 	 sự trả lời; trả lời
anti- prefix	chống lại
anticipate 	 thấy trước, lường trước
anxiety 	 mối lo âu, sự lo lắng
anxious 	 lo âu, băn khoăn
anxiously 	 lo âu, băn khoăn
any 	 một người, vật nào đó
anyone 	 người nào, bất cứ ai
anything 	 việc gì; bất cứ việc gì
anyway 	 thế nào cũng được, dù sao chăng nữa
anywhere 	 bất cứ chỗ nào, bất cứ nơi đâu
apart 	 về một bên, qua một bên
apart from		ngoài...ra
apartment 	căn phòng, căn buồng
apologize  	xin lỗi, tạ lỗi
apparent 	 rõ ràng, bề ngoài
apparently 	 nhìn bên ngoài, hình như
appeal 	 sự kêu gọi, cầu khẩn
appear 	hiện, hiện ra
appearance 		 sự xuất hiện, sự trình diện
apple 	 quả táo
application 	sự gắn vào; sự chuyên cần
apply 	 gắn vào, ghép vào, áp dụng vào
appoint 	 bổ nhiệm, chỉ định, chọn
appointment 	 sự bổ nhiệm, người được bổ nhiệm
appreciate 	 thấy rõ; nhận thức
approach 	 đến gần, lại gần; sự đến gần, sự lại gần
appropriate 	 thích hợp, thích đáng
approval 	sự tán thành, đồng ý
approve (of) 	tán thành, đồng ý
approving 	tán thành, đồng ý
approximate 	 giống với, giống hệt với
approximately 	 khoảng chừng, độ chừng
April 	 tháng Tư
area 	 diện tích, bề mặt
argue 	 chứng tỏ, chỉ rõ
argument 	 lý lẽ
arise 	 xuất hiện, nảy ra
arm 	 cánh tay; vũ trang
arms 	 vũ khí, binh giới, binh khí
armed 	 vũ trang
army 	 quân đội
around 	 xung quanh, vòng quanh
arrange 	 sắp xếp, sắp đặt, sửa soạn
arrangement 	 sự sắp xếp, sự sửa soạn
arrest 	 bắt giữ, sự bắt giữ
arrival 	 sự đến, sự tới nơi
arrive 	 đến, tới nơi
arrow 	 tên, mũi tên
art nghệ thuật, mỹ thuật
article bài báo, đề mục
artificial  nhân tạo
artificially    nhân tạo
artist  nghệ sĩ
artistic    thuộc nghệ thuật, thuộc mỹ thuật
as  như
ashamed ngượng, xấu hổ
aside 	một bên, sang một bên
aside from	ngoài ra, trừ ra
apart from	... ra
ask	hỏi
asleep	 ngủ, đang ngủ
fall asleep	ngủ thiếp đi
aspect 	vẻ bề ngoài, diện mạo
assist 	 giúp, giúp đỡ; tham dự, có mặt
assistance 	 sự giúp đỡ
assistant 	người giúp đỡ, phụ tá
associate 	 kết giao, cộng tác
associated with	liên kết với
association 	 sự kết hợp, sự liên kết
assume 	 mang, khoác
assure 	 đảm bảo, cam đoan
atmosphere 	 khí quyển
atom 	 nguyên tử
attach 	 gắn, dán
attached 	 gắn bó
attack 	 sự tấn công, công kích
attempt 	 cố gắng, thử
attempted 	 cố gắng, thử
attend 	 dự, có mặt
attention 	 sự chú ý
pay attention (to)	chú ý tới
attitude 	 thái độ, quan điểm
attorney 	 người được ủy quyền
attract 	 hút; thu hút, hấp dẫn
attraction 	 sự hút, sức hút
attractive 	 hút, thu hút
audience 	 thính, khan giả
August 	 tháng Tám
aunt 	 cô, dì
author 	 tác giả
authority 	 uy quyền, quyền lực
automatic 	tự động
automatically 	một cách tự động
autumn 	 mùa thu
available 	 có giá trị, hiệu lực
average 	 trung bình, mức trung bình
avoid 	 tránh, tránh xa
awake 	 đánh thức, làm thức dậy
award 	 phần thưởng; tặng thưởng
aware 	 biết, nhận thức, nhận thức thấy
away 	 xa, xa cách
awful 	 oai nghiêm, dễ sợ
awfully a	dv. tàn khốc, khủng khiếp
awkward 	 vụng về, lung túng
awkwardly 	 vụng về, lung túng
back 	lưng, trở lại
background 	 phía sau; nền
backward 	về phía sau, lùi lại
bacteria 	vi khuẩn
bad 	 tồi
go bad	bẩn thỉu, hỏng
badly 	 xấu, tồi
bad-tempered 	 xấu tính, dễ nổi cáu
bag 	 bao, cặp xách
baggage 	 hành lý
bake 		 nung, nướng bằng lò
balance 	 cái cân; làm cho cân bằng
ball 	 quả bóng
ban 	 cấm, sự cấm
band 	 băng, đai
bandage 	 dải băng; băng bó
bank	bờ (sông...) , đê
bar 	 quán bán rượu
bargain 	 sự mặc cả, sự giao kèo mua bán
barrier 	 đặt chướng ngại vật
base 	 cơ sở, đặt cơ sở trên cái gì
based on	 dựa trên
basic 	 cơ bản, cơ sở
basically 	 cơ bản, về cơ bản
basis 	 nền tảng, cơ sở
bath 	 sự tắm
bathroom 	 buồng tắm, nhà vệ sinh
battery 	 pin, ắc quy
battle 	 trận đánh, chiến thuật
bay 	n. /bei/ gian (nhà),chuồng (ngựa)
bays	vòng nguyệt quế
beach 	bãi biển
beak 		 mỏ chim
bear 	 mang, cầm
beard 	 râu
beat 	 tiếng đập; đánh đập
beautiful	 đẹp
beautifully 	 tốt đẹp, đáng hài lòng
beauty 	 vẻ đẹp; người đẹp
because 	 bởi vì, vì
because of	vì, do bởi
become	trở thành, trở nên
bed 	 cái giường
bedroom 	 phòng ngủ
beef 	 thịt bò
beer 	 rượu bia
before 	 trước, đằng trước
begin 	 bắt đầu, khởi đầu
beginning 	 phần đầu, lúc khởi đầu
behalf 	 sự thay mặt
on behalf of sb	thay mặt cho ai, nhân danh ai
on sb’s behalf	nhân danh cá nhân ai
behave 	 đối xử, cư xử
behind 	 sau, ở đằng sau
belief 	 đức tin, sự tin tưởng
believe 	 tin, tin tưởng
bell 	 cái chuông, tiếng chuông
belong 	 thuộc về, thuộc quyền sở hữu
below 	 dưới thấp, phía dưới
belt 	dây lưng, thắt lưng
bend 	chỗ rẽ; khuỷu tay
bent 	 khiếu, sở thích
beneath 	 ở dưới, dưới thấp
benefit 	 lợi ích; giúp ích
beside 	 bên cạnh, so với
bet 	 cá cược; sự đánh cuộc
betting 	 sự đánh cuộc
between 	 giữa, ở giữa
beyond 	 ở xa, phía bên kia
bicycle 	 xe đạp
bid 	 trả giá; sự trả giá
big 	 to, lớn
bill 	 hóa đơn, giấy bạc
bin 	thùng, thùng đựng rượu
biology 	 sinh vật học
bird 	 chim
birth 	 sự ra đời, sự sinh đẻ
give birth	sinh ra
birthday	ngày sinh, sinh nhật
biscuit	bánh quy
bit 	miếng, mảnh
a bit	một chút, một tí
bite 	 cắn; sự cắn
bitter 	 đắng; đắng cay, chua xót
bitterly 	 đắng cay, chua xót
black 	đen; màu đen
blade 	 lưỡi (dao, kiếm); lá (cỏ, cây
blame 	 khiển trách; sự khiển trách
blank 	 trống; sự trống rỗng
blankly 	 ngây ra, không có thần
blind 	 đui, mù
block 	 khối, tảng (đá); làm ngăn chặn
blonde 	 hoe vàng, mái tóc hoe vàng
blood 	 máu, huyết; sự tàn sát, chem giết
blow 	 nở hoa; sự nở hoa
blue 	 xanh, màu xanh
board 	 tấm ván; lát ván
(on) board	trên tàu thủy
boat 	tàu, thuyền
body 	 thân thể, thân xác
boil 	 sôi, luộc
bomb 	 quả bom; thả bom
bone 	 xương
book 	 sách; ghi chép
boot 	 giày ống
border 	 bờ, lề (đường)
bore 	 buồn chán, buồn tẻ
boring 	 buồn chán
bored 	 buồn chán
born	sinh, đẻ
borrow 	vay, mượn
boss 	 ông chủ, thủ trưởng
both 	 cả hai
bother 	làm phiền, quấy rầy
bottle 	 chai, lọ
bottom 	 phần dưới cùng; cuối cùng
bound 	 nhất định, chắc chắn
bowl 	 cái bát
box 	 hộp, thùng
boy 	 con trai, thiếu niên
boyfriend 	 bạn trai
brain 	 óc não; đầu óc, trí não
branch 	 ngành; nhành cây
brand 	 nhãn (hàng hóa)
brave 	 gan dạ, can đảm
bread 	 bánh mỳ
break 	 đập vỡ; sự vỡ
broken 	 bị gãy, bị vỡ
breakfast 	 bữa điểm tâm, bữa sáng
breast 	 ngực, vú
breath 	 hơi thở, hơi
breathe 	 hít, thở
breathing 	sự hô hấp, sự thở
breed 	 nuôi dưỡng, nòi giống
brick 	 gạch
bridge 	 cái cầu
brief 	 ngắn gọn, vắn tắt
briefly 	 ngắn gọn, vắn tắt
bright 	 sáng, sáng chói
brightly 	 sáng chói, tươi
brilliant 	 tỏa sáng, rực rỡ
bring 	mang, cầm , xách lại
broad 	 rộng
broadly 	 rộng, rộng rãi
broadcast 	 truyền rộng rãi; quảng bá
brother 	 anh, em trai
brown 	 nâu, màu nâu
brush 	 bàn chải;  quét
bubble 	bọt, tăm
budget 	 ngân sách
build 	 xây dựng
building 	 công trình xây dựng; tòa nhà
bullet 	đạn (súng trường, súng lục)
bunch 	búi, chùm, bó
burn 	 đốt cháy, thắp
burnt 	 bị cháy; rám nắng
burst 	 nổ (bom); vỡ (bong bóng)
bury 	 chôn cất, mai táng
bus 	 xe buýt
bush 	 bụi cây, bụi rậm
business 	 việc buôn bán, kinh doanh
businessman, businesswoman	thương nhân
busy 	 bận, bận rộn
but 	 nhưng
butter 	 bơ
button 	 cái nút, cái khuy
buy 	 mua
buyer 	 người mua
by 	 bởi, bằng
bye 	 tạm biệt
cent 	 đồng xu (bằng 1/100 đô la)
cabinet 	 tủ có nhiều ngăn đựng đồ
cable 	 dây cáp
cake 	bánh ngọt
calculate 	 tính toán
calculation 	 sự tính toán
call 	 gọi; tiếng kêu
be called	được gọi, bị gọi
calm 	 làm dịu đi; sự yên lặng
calmly 	 yên lặng, điềm tĩnh
camera 	 máy ảnh
camp 	 trại; cắm trại
camping 	sự cắm trại
campaign 	 chiến dịch, cuộc vận động
can modal 	 có thể; nhà tù
cannot	không thể
could modal 	 có thể
cancel 	 hủy bỏ, xóa bỏ
cancer 	 bệnh ung thư
candidate 	 người ứng cử, thí sinh
candy 	 kẹo
cap 	 mũ lưỡi trai, mũ vải
capable 	 có năng lực; có khả năng
capacity 	 năng lực, khả năng tiếp thu
capital 	 thủ đô, chủ yếu
captain 	 người cầm đầu, thủ lĩnh
capture 	 bắt giữ, bắt; sự bắt giữ
car 	xe hơi
card 	 thẻ, thiếp
cardboard 	bìa cứng, các tông
care 	 sự chăm sóc; chăm sóc
take care (of	sự giữ gìn
care for	trông nom, chăm sóc
career 	 nghề nghiệp, sự nghiệp
careful 	 cẩn thận, biết giữ gìn
carefully 	 cẩn thận, chu đáo
careless 	 sơ suất, cầu thả
carelessly 	cẩu thả, bất cẩn
carpet 	 tấm thảm, thảm (cỏ)
carrot 	 củ cà rốt
carry 	 mang, vác
case 	 vỏ, ngăn
in case (of)	nếu......
cash 	tiền, tiền mặt
cast 	 ném, sự ném (lưới)
castle 	 thành trì, thành quách
cat 	 con mèo
catch 	 bắt lấy, tóm lấy
category 	 loại; phạm trù
cause 	 nguyên nhân; gây nên
cease 	 dừng, ngừng
ceiling 	 trần nhà
celebrate 	 kỷ niệm; tán dương
celebration 	 sự kỷ niệm; sự tán dương
cell 	 ô, ngăn
cellphone 	 điện thoại di động
cent 	 đồng xu (=1/100 đô la)
centimetre 	 xen ti met
central 	 trung tâm, trung ương
centre 	 điểm giữa, trung tâm
century 	 thế kỷ
ceremony 	 nghi thức, nghi lễ
certain 	 chắc chắn
certainly 	 chắc chắn, nhất định
uncertain 	thiếu chính xác, không chắc chắn
certificate 	 giấy chứng nhận, bằng, chứng chỉ
chain 	 dây, trói lại
chair 	ghế
chairman, chairwoman 	 chủ tịch, chủ tọa
challenge 	 sự thử thách; thử thách
chamber 	 buồng, phòng
chance 	 sự may mắn
change 	 thay đổi, sự thay đổi
channel 	kênh (TV, radio), eo biển
chapter 	 chương (sách)
character 	tính cách, đặc tính, nhân vật
characteristic 	 riêng biệt, đặc trưng
charge 	 nhiệm vụ; giao nhiệm vụ
in charge of	phụ trách
charity 	lòng từ thiện; sự bố thí
chart 	 biểu đồ; lập biểu đồ
chase 	 săn bắt; sự săn bắt
chat 	nói chuyện; chuyện phiếm
cheap 	 rẻ
cheaply 	rẻ, rẻ tiền
cheat 	 lừa đảo; trò gian lận
check 	 kiểm tra; sự kiểm tra
cheek 	 má
cheerful 	 vui mừng, phấn khởi
cheerfully 	 vui vẻ, phấn khởi
cheese 	 pho mát
chemical 	thuộc hóa học; chất hóa học
chemist 	 nhà hóa học
chemistry 	 hóa học, môn hóa học
cheque 	 séc
chest 	tủ, rương, hòm
chew 	 nhai, ngẫm nghĩ
chicken 	 gà, thịt gà
chief 	trọng yếu; thủ lĩnh
child 	 đứa bé, đứa trẻ
chin 	 cằm
chip 	 mảnh vỡ, chỗ sứt mẻ
chocolate 	sô cô la
choice 	 sự lựa chọn
choose 	 chọn, lựa chọn
chop 	 chặt, đốn, chẻ
church 	 nhà thờ
cigarette 	 điếu thuốc lá
cinema 	rạp phim, rạp chiếu bóng
circle 	 đường tròn, hình tròn
circumstance 	hoàn cảnh, tình huống
citizen 	 người thành thị
city 	 thành phố
civil 	 (thuộc) công dân
claim 	 đòi hỏi; sự thỉnh cầu
clap 	 vỗ; tiếng vỗ tay
class 	 lớp học
classic 	 cổ điển, kinh điển
classroom 	 lớp học, phòng học
clean 	 sạch, sạch sẽ;
clear 	 lau chùi, quét dọn
clearly 	 rõ ràng, sáng sủa
clerk 	 thư ký, linh mục
clever 	 lanh lợi, thông minh
click 	 làm thành tiếng lách cách;, cú nhắp (chuột)
client 	 khách hàng
climate 	khí hậu, thời tiết
climb 	 leo, trèo
climbing 	 sự leo trèo
clock 	 đồng hồ
close 	 đóng kín, chật chội
closely 	 chặt chẽ, kỹ lưỡng
close 	 đóng, chấm dứt
closed 	 bảo thủ, khép kín
closet 	 buồng, phòng để đồ
cloth 	 vải, khăn trải bàn
clothes 	 quần áo
clothing 	quần áo, y phục
cloud 	 mây, đám mây
club 	 câu lạc bộ; dùi cui
centimetre 	 xen ti mét (đơn vị đo)
coach 	 huấn luyện viên
coal 	 than đá
coast 	 sự lao dốc; bờ biển
coat 	 áo choàng
code 	 mật mã, điều lệ
coffee 	 cà phê
coin 	 tiền kim loại
cold 	 lạnh, sự lạnh lẽo
coldly 	 lạnh nhạt, vô tâm
collapse 	 sụp đổ; sự đổ nát
colleague 	 bạn đồng nghiệp
collect 	 sưu tập, tập trung lại
collection 	 sự sưu tập, sự tụ họp
college 	 trường cao đẳng, trường đại học
colour 	 màu sắc; tô màu
coloured 	 mang màu sắc, có màu sắc
column 	cột , mục (báo)
combination 	 sự kết hợp, sự phối hợp
combine 	 kết hợp, phối hợp
come 	 đi đến, đi tới
comedy 	 hài kịch
comfort 	 sự an ủi, khuyên giải
comfortable 	 thoải mái, tiện nghi
comfortably 	 dễ chịu, thoải mái
uncomfortable 	 bất tiện, khó chịu
command 	 ra lệnh; mệnh lệnh
comment 	 lời bình luận; bình luận
commercial 	 buôn bán, thương mại
commission 	 hội đồng;sự ủy thác
commit 	 ủy nhiệm; tống giam
commitment 	 sự tận tụy; sự phạm tội
committee 	 ủy ban
common 	 công cộng, phổ biến
commonly 	thông thường, bình thường
communicate 	 truyền đạt; liên lạc
communication 	 sự giao tiếp, liên lạc
community 	dân chúng, nhân dân
company 	 công ty
compare 	 so sánh, đối chiếu
comparison 	 sự so sánh
compete 	 đua tranh, cạnh tranh
competition 	 sự cạnh tranh, cuộc thi
competitive 	 cạnh tranh, đua tranh
complain 	 phàn nàn, kêu ca
complaint 	 lời than phiền; sự khiếu nại
complete 	 hoàn thành, xong;
completely 	 hoàn thành, đầy đủ
complex 	 phức tạp, rắc rối
complicate 	 làm phức tạp, rắc rối
complicated 	phức tạp, rắc rối
computer 	 máy tính
concentrate 	 tập trung
concentration 	sự tập trung, nơi tập trung
concept 	 khái niệm
concern 	 liên quan; sự dính líu tới
concerned 	 có liên quan, có dính líu
concerning 	 bâng khuâng, ái ngại
concert 	 buổi hòa nhạc
conclude 	 kết luận, chấm dứt (công việc)
conclusion 	 sự kết thúc, sự kết luận
concrete 	 bằng bê tông; bê tông
condition 	điều kiện, tình cảnh
conduct 	 điều khiển, chỉ đạo
conference 	 hội nghị, sự bàn bạc
confidence 	 lòng tin tưởng, sự tin cậy
confident 	 tin tưởng, tự tin
confidently 	 tự tin
confine 	giam giữ, hạn chế
confined 	 hạn chế, giới hạn
confirm 	 xác nhận, chứng thực
conflict 	 xung đột; sự xung đột
confront 	đối mặt, đối diện
confuse 	làm lộn xộn, xáo trộn
confusing 	 khó hiểu, gây bối rối
confused 	 bối rối, lúng túng
confusion 	 sự lộn xộn, sự rối loạn
congratulations 	 sự chúc mừng, khen ngợi
congress 	 đại hội, Quốc hội
connect 	 kết nối, nối
connection 	 sự kết nối, sự giao kết
conscious 	 tỉnh táo, có ý thức
unconscious 	 bất tỉnh, không có ý thức
consequence 	 kết quả, hậu quả
conservative 	 thận trọng, dè dặt, bảo thủ
consider 	 cân nhắc; quan tâm
considerable 	 lớn lao, to tát, đáng kể
considerably 	 đáng kể, lớn lao, nhiều
consideration 	 sự cân nhắc, sự quan tâm
consist of 	 gồm có
constant 	kiên trì, bền lòng
constantly 	kiên định
construct 	 xây dựng
construction 	 sự xây dựng
consult 	tra cứu, tham khảo
consumer 	người tiêu dùng
contact 	 sự liên lạc; tiếp xúc
contain 	 bao hàm, chứa đựng
container 	 cái chứa đựng; công te nơ
contemporary 	 đương thời, đương đại
content 	 nội dung, sự hài lòng
contest 	 cuộc thi, trận đấu
context 	văn cảnh, phạm vi
continent 	 lục địa, đại lục
continue 	 tiếp tục, làm tiếp
continuous 	 liên tục, liên tiếp
continuously 	 liên tục, liên tiếp
contract 	 hợp đồng; ký kết
contrast 	 sự tương phản; làm tương phản
contrasting 	 tương phản
contribute 	đóng góp, ghóp phần
contribution 	sự đóng góp, sự góp phần
control 	sự điều khiển, quyền chỉ huy
in control (of)	trong sự điều khiển của
under control	dưới sự điều khiển của
controlled 	 được điều khiển, được kiểm tra
uncontrolled 	 không bị điều khiển, không bị kiểm tra
convenient 	 tiện lợi, thuận lợi
convention 	hội nghị, hiệp định, quy ước
conventional 	 quy ước
conversation 	 cuộc đàm thoại, cuộc trò chuyện
convert 	 đổi, biến đổi
convince 	thuyết phục; làm cho nhận thức thấy
cook 	 nấu ăn, người nấu ăn
cooking 	 sự nấu ăn, cách nấu ăn
cooker 	 lò, bếp
cookie 	 bánh quy
cool 	 mát mẻ; làm mát
cope (with) 	 đối phó, đương đầu
copy 	 bản sao; sự sao chép
core 	 nòng cốt; đáy lòng
corner 	 góc (tường, nhà, phố...)
correct 	 chính xác; sửa chữa
correctly 	 đúng, chính xác
cost 	 chi phí; trả giá
cottage 	 nhà tranh
cotton 	 bông, sợi chỉ
cough 	 ho, tiếng ho
coughing 	 ho
could 	có thể, có khả năng
council 	 hội đồng
count 	 đếm, tính
counter 	 quầy hàng, máy đếm
country 	 quốc gia, đất nước
countryside 	 miền quê, miền nông thôn
county 	 hạt, tỉnh
couple 	 đôi, cặp; đôi vợ chồng, cặp nam nữ
a couple	một cặp, một đôi
courage 	 sự can đảm, sự dũng cảm, dũng khí
course 	 tiến trình, quá trình diễn tiến
of course	dĩ nhiên
court 	 sân (tennis...), phiên tòa
cousin 	 anh em họ
cover 	 bao bọc; vỏ bọc
covered 	 có mái che, kín đáo
covering 	 sự bao bọc, sự che phủ
cow 	 con bò cái
crack 	 xuất sắc; làm nứt
cracked 	 rạn, nứt
craft 	nghề, nghề thủ công
crash 	 vải thô; sự phá sản
crazy 	 điên, mất trí
cream 	 kem
create 	 sáng tạo, tạo nên
creature 	 sinh vật, loài vật
credit 	 sự tin; tiền gửi ngân hàng
credit card 	 thẻ tín dụng
crime 	 tội ác, tội phạm
criminal 	 phạm tội; tội phạm
crisis 	 sự khủng hoảng, cơn khủng hoảng
crisp 	 giòn
criterion 	 tiêu chuẩn
critical 	 phê bình; khó tính
criticism 	 sự phê bình, lời phê bình
criticize 	 phê bình, chỉ trích
crop 	 vụ mùa
cross 	 cây Thánh Giá; sự băng qua
crowd 	 đám đông
crowded 	 đông đúc
crown 	vương miện, ngai vàng
crucial 	 quyết định, chủ yếu
cruel 	 độc ác, tàn nhẫn
crush 	 ép, đè bẹp
cry 	 khóc; sự khóc
cultural 	 (thuộc) văn hóa
culture 	 văn hóa, sự mở mang
cup 	 tách, chén
cupboard 	 1 loại tủ có ngăn
curb 	kiềm chế, hạn chế
cure 	 điều trị; cách chữa bệnh
curious 	 ham muốn, tò mò
curiously 	 tò mò, hiếu kỳ
curl 	 làm xoắn; sự uốn quăn
curly 	 quăn, xoắn
current 	 hiện hành, phổ biến
currently 	 hiện thời, hiện nay
curtain 	 màn (cửa, rạp hát, khói, sương)
curve 	 đường cong; uốn cong
curved 	 cong
custom 	 phong tục, tục lệ
customer 	 khách hàng
customs 	 thuế nhập khẩu, hải quan
cut 	cắt; sự cắt
cycle 	 vòng; đi xe đạp
cycling 	 sự đi xe đạp
dad 	 bố, cha
daily 	 hàng ngày
damage 	 sự thiệt hại; làm hư hại
damp 	 ẩm ướt, ẩm thấp
dance 	 sự nhảy múa; nhảy múa
dancing 	 sự nhảy múa, sự khiêu vũ
dancer 	 diễn viên múa, người nhảy múa
danger 	sự nguy hiểm; nguy cơ
dangerous 	 nguy hiểm
dare	dám đương đầu với; thách
dark 	tối tăm; bóng tối
data 	số liệu, dữ liệu
date 	 ngày; đề ngày tháng
daughter 	 con gái
day 	 ngày, ban ngày
dead 	 chết, tắt
deaf 	 điếc, làm thinh, làm ngơ
deal 	 phân phối; sự giao dịch
deal with	giải quyết
dear 	 thân mến; kính thưa
death 	sự chết, cái chết
debate 	 cuộc tranh luận; tranh luận
debt 	 nợ
decade 	 thập kỷ
decay 	 tình trạng suy tàn, suy sụp
December 	 /di'sembə/ tháng mười hai, tháng Chạp
decide 	quyết định, giải quyết
decision 	 sự quyết định, sự giải quyết
declare 	 tuyên bố, công bố
decline 	 sự suy tàn; suy tàn
decorate 	 trang hoàng, trang trí
decoration 	 sự trang hoàng, trang trí
decorative 	 để trang hoàng, để trang trí
decrease 	 giảm bớt, sự giảm sút
deep 	sâu, bí ẩn
deeply 	 sâu, sâu xa
defeat 	  bại; sự thất bại (1 kế hoạch)
defence 	 cái để bảo vệ, sự che chở
defend 	 che chở, bào chữa
define 	 định nghĩa
definite 	 xác định, định rõ
definitely 	 rạch ròi, dứt khoát
definition 	 sự định nghĩa, lời định nghĩa
degree 	mức độ, trình độ; bằng cấp; độ
delay 	 sự chậm trễ; làm chậm trễ
deliberate 	 thận trọng, có tính toán
deliberately 	 thận trọng, có suy nghĩ cân nhắc
delicate 	thanh nhã, tế nhị
delight 	 sự vui sướng; làm say mê
delighted 	 vui mừng, hài lòng
deliver 	 thoát khỏi, bày tỏ
delivery 	 sự phân phối; sự bày tỏ
demand 	 sự đòi hỏi; đòi hỏi
demonstrate 	 chứng minh; bày tỏ
dentist 	 nha sĩ
deny 	 từ chối, phản đối
department 	 cục sở; gian hàng
departure 	 sự rời khỏi, sự khởi hành
depend (on) 	 phụ thuộc; dựa vào
deposit 	 tiền gửi; đặt cọc
depress 	làm phiền muộn; làm suy giảm
depressing 	 làm chán nản làm thát vọng, làm trì trệ
depressed 	 chán nản; suy yếu
depth 	chiều sâu, độ dày
derive 	nhận được từ; bắt nguồn
describe 	 diễn tả, miêu tả, mô tả
description 	 sự mô tả, sự miêu tả
desert 	 sa mạc; công lao; bỏ trốn
deserted 	 hoang vắng, không người ở
deserve 	 đáng, xứng đáng
design 	 sự thiết kế; thiết kế
desire 	 ước muốn; thèm muốn
desk 	 cái bàn
desperate 	 liều lĩnh; tuyệt vọng
desperately 	 liều lĩnh, liều mạng
despite 	 mặc dù, bất chấp
destroy 	 phá hoại, triệt phá
destruction 	 sự phá hoại, sự tiêu diệt
detail 	 chi tiết
in detail	tường tận, tỉ mỉ
detailed 	 cặn kẽ, nhiều chi tiết
determination 	 sự xác định; sự quyết định
determine 	xác định; quyết định
determined 	 đã được xác định, đã được xác định rõ
develop 	 phát triển; trình bày
development 	sự phát triển; sự bày tỏ
device 	 kế sách; thiết bị, dụng cụ
devote 	hiến dâng, dành hết cho
devoted 	 hiến dâng; hết lòng
diagram 	 biểu đồ
diamond 	 kim cương
diary 	sổ nhật ký; lịch ghi nhớ
dictionary 	 từ điển
die 	 chết, hy sinh
dying 	 sự chết
diet 	chế độ ăn uống, chế độ ăn kiêng
difference 	 sự khác nhau
different 	 khác biệt, khác nhau
differently 	 khác biệt, khác nhau
difficult 	 khó khăn, gay go
difficulty 	 sự khó khăn, nỗi khó khăn, điều cản trở
dig 	 đào bới, xới
dinner 	 bữa trưa, chiều
direct 	 trực tiếp, thẳng thắn
directly 	 trực tiếp, thẳng
direction 	 sự điều khiển, sự chỉ huy
director 	 giám đốc, chỉ huy
dirt 	đồ bẩn thỉu, vật rác rưởi
dirty 	 bẩn thỉu, dơ bẩn
disabled 	 bất lực, không có khă năng
disadvantage 	 sự bất lợi, sự thiệt hại
disagree 	bất đồng; không hợp
disagreement 	sự bất đồng, sự khác nhau
disappear 	biến mất, biến đi
disappoint 	 không làm thỏa ước nguyện, ý mong đợi
disappointing 	 làm chán ngán, làm thất vọng
disappointed 	 thất vọng
disappointment 	 sự chán ngán, sự thất vọng
disapproval 	sự phản đổi, sự không tán thành
disapprove (of) 	 không tán thành, phản đối
disapproving 	 phản đối
disaster 	 tai họa, thảm họa
disc 	 đĩa
discipline 	 kỷ luật
discount 	sự bớt giá, chiết khấu
discover 	 khám phá, nhận ra
discovery 	 sự khám phá, sự phát hiện ra
discuss 	 thảo luận, tranh luận
discussion 	 sự thảo luận, sự tranh luận
disease 	 căn bệnh, bệnh tật
disgust 	 làm ghê tởm, làm phẫn nộ
disgusting 	 làm ghê tởm, kinh tởm
disgusted 	 chán ghét, phẫn nộ
dish 	 đĩa (đựng thức ăn)
dishonest 	 bất lương, không thành thật
dishonestly 	bất lương, không lương thiện
disk 	 đĩa, đĩa hát
dislike 	 không thích, sự ghét
dismiss 	 giải tán (quân đội, đám đông); sa thải (người làm)
display 	trưng bày; sự trưng bày
dissolve 	 tan rã, giải tán
distance 	 khoảng cách, tầm xa
distinguish 	phân biệt, nhận ra
distribute 	 sắp xếp, phân loại
distribution 	 sự phân phát, sự sắp xếp
district 	 huyện, quận
disturb 	làm náo động, quấy rầy
disturbing 	 xáo trộn
divide 	 chia, chia ra, phân ra
division n. /dɪ'vɪʒn/ sự phân chia, sự phân loại
divorce 	 sự ly dị
divorced 	 đã ly dị
do 	 làm
undo 	 tháo gỡ; xóa bỏ
doctor 	 bác sĩ y khoa, tiến sĩ
document 	 tài liệu, tư liệu
dog 	 chó
dollar 	 đô la Mỹ
domestic 	 vật nuôi trong nhà, (thuộc) nội trợ
dominate 	 chiếm ưu thế; kiềm chế
door 	cửa, cửa ra vào
dot 	 chấm nhỏ; của hồi môn
double 	đôi; cái gấp đôi
doubt 	 sự nghi ngờ; nghi ngờ
down 	 xuống
downstairs 	 ở tầng dưới; tầng dưới
downwards 	 xuống, đi xuống
downward 	 xuống, đi xuống
dozen 	 tá (12)
draft 	bản phác thảo; phác thảo
drag 	 lôi kéo, kéo lê
drama 	kịch, tuồng
dramatic 	như đóng kịch, thích hợp với sân khấu
dramatically 	 đột ngột
draw 	 vẽ, kéo
drawing 	 bản vẽ, sự kéo
drawer 	người vẽ, người kéo
dream 	 giấc mơ, mơ
dress 	 quần áo, mặc (quần áo)
dressed 	cách ăn mặc
drink 	 đồ uống; uống
drive 	 lái; cuộc đua xe (điều khiển)
driving 	sự lái xe, cuộc đua xe
driver 	 người lái xe
drop 	 rơi; giọt (nước, máu...)
drug 	thuốc, dược phẩm; ma túy
drugstore 	 hiệu thuốc, cửa hàng dược phẩm
drum 	cái trống, tiếng trống
drunk 	 say rượu
dry 	 khô cạn; làm khô
due 	đến kỳ hạn (trả nợ); xứng đáng, thích đáng
due to	vì, do 
dull 	 chậm hiểu, ngu đần
dump 	 đổ rác; đống rác
during 	 trong lúc, trong thời gian
dust 	 bụi; rắc (bụi, phấn)
duty 	 sự kính trọng; trách nhiệm
each 	 mỗi
each 	nhau, lẫn nhau
ear 	tai
early 	 sớm
earn 	kiếm (tiền), giành (phần thưởng)
earth 	 đất, trái đất
ease 	 sự thoải mái; làm dễ chịu
east 	hướng đông, phía đông
eastern 	 đông
easy 	 dễ dàng, dễ tính
easily 	 dễ dàng
eat 	 ăn
economic 	(thuộc) Kinh tế
economy 	 sự tiết kiệm, sự quản lý kinh tế
edge 	lưỡi, cạnh sắc
edition 	 nhà xuất bản, sự xuất bản
editor 	người thu thập và xuất bản, chủ bút
educate 	 giáo dục; rèn luyện
educated 	 được giáo dục, được đào tạo
education 	 sự giáo dục, sự rèn luyện (kỹ năng)
effect 	hiệu ứng, kết quả
effective 	 có kết quả, có hiệu lực
effectively 	 có kết quả, có hiệu lực
efficient 	 có hiệu lực, có hiệu quả
efficiently 	 có hiệu quả, hiệu nghiệm
effort 	 sự cố gắng, sự nỗ lực
egg 	 trứng
either 	mỗi một; cũng phải thế
elbow 	 khuỷu tay
elderly 	 có tuổi, cao tuổi
elect 	 bầu, quyết định
election 	 sự bầu cử, cuộc tuyển cử
electric 	 (thuộc) điện, phát điện
electrical 	 (thuộc) điện
electricity 	 điện lực; điện lực học
electronic 		(thuộc) điện tử
elegant 	thanh lịch, tao nhã
element 	 yếu tôd, nguyên tố
elevator 	 máy nâng, thang máy
else 	  nữa; nếu không
elsewhere 	 ở một nơi nào khác
email 	 thư điện tử; gửi thư điện tử
embarrass 	 lúng túng; gây khó khăn
embarrassing 	 làm lúng túng, ngăn trở
embarrassed 	 lúng túng; mang nợ
embarrassment 	 sự lúng túng, sự bối rối
emerge 	 nổi lên; nổi bật lên
emergency 	 tình trạng khẩn cấp
emotion 	 xự xúc động, sự cảm động
emotional 	 cảm động; dễ cảm động
emotionally 	 xúc động
emphasis 	sự nhấn mạnh, tầm quan trọng
emphasize 	 nhấn mạnh, làm nổi bật
empire 	 đế chế, đế quốc
employ 	dùng, thuê ai làm gì
unemployed 	 thất nghiệp; không sử dụng được
employee 	 người lao động, người làm công
employer 	chủ, người sử dụng lao động
employment 	 sự thuê mướn
unemployment 	sự thất nghiệp, nạn thất nghiệp
empty 	 trống rỗng
enable 	 có khả năng; cho phép ai làm gì
encounter 	 chạm chán; sự chạm trán
encourage 	 động viên, ủng hộ
encouragement niềm cổ vũ, động viên
end 	 sự kết thúc; chấm dứt
in the end	cuối cùng, về sau
ending 	 sự kết thúc; kết cục
enemy 	 kẻ thù, quân địch
energy 	 năng lượng, sinh lực
engage 	 hứa hẹn, đính ước
engaged 	đã đính ước; đã có người
engine 	máy, động cơ
engineer 	 kỹ sư
engineering 	 nghề kỹ sư, công việc của kỹ sư
enjoy 	 thưởng thức, thích thú cái gì
enjoyable 	 thú vị, thích thú
enjoyment 	 sự thích thú, sự có được
enormous 	 to lớn, khổng lồ
enough 	 đủ
enquiry 	 sự điều tra, sự thẩm vấn
ensure 	 bảo đảm, chắc chắn
enter 	đi vào, gia nhập
entertain 	 giải trí, chiêu đãi
entertaining 	 giải trí
entertainer 	 người quản trò, người tiếp đãi
entertainment 	 sự giải trí, sự tiếp đãi
enthusiasm 	 sự hăng hái, sự nhiệt tình
enthusiastic 	 hăng hái, say mê
entire 	toàn thể, toàn bộ
entirely 	 trọn vẹn, toàn bộ
entitle 	 cho tiêu đề; cho quyền làm gì
entrance 	 sự đi vào, sự nhậm chức
entry 	sự ghi vào sổ sách, sự tiếp nhận (pháp lý)
envelope 	 phong bì
environment 	 môi trường, hoàn cảnh xung quanh
environmental 	 thuộc về môi trường
equal 	 ngang, bằng; người ngang
equally 	 bằng nhau, ngang bằng
equipment 	 trang, thiết bị
equivalent 	 tương đương; vật tương đương
error 	lỗi, sự sai sót, sai lầm
escape 	trốn thoát; sự trốn thoát
especially 	 đặc biệt là, nhất là
essay 	 bài tiểu luận
essential 	 bản chất; yếu tố cần thiết
essentially 	 về bản chất, về cơ bản
establish 	 lập, thành lập
estate 	 tài sản, di sản
estimate 	 sự ước lượng; ước lượng
et cetera 	 vân vân
euro 	đơn vị tiền tệ của liên minh châu Âu
even 	 ngay cả; bằng phẳng
evening 	 buổi chiều, tối
event 	 sự việc, sự kiện
eventually 	 cuối cùng
ever 	từng, từ trước tới giờ
every 	mỗi, mọi
everyone 	 mọi người
everything 	 mọi vật, mọi thứ
everywhere 	 mọi nơi
evidence 	 điều hiển nhiên, điều rõ ràng
evil 	xấu xa; điều xấu
exact 	 chính xác, đúng
exactly 	 chính xác, đúng đắn
exaggerate 	 cường điệu, phóng đại
exaggerated 	 cường điệu, phòng đại
exam 	viết tắt của Examination
examination 	 sự thi cử, kỳ thi
examine 	 thẩm tra, hỏi han (thí sinh)
example 	 thí dụ, ví dụ
excellent 	 xuất sắc, xuất chúng
except 	 trừ ra, không kể; trừ phi
exception 	 sự trừ ra, sự loại ra
exchange 	 trao đổi; sự trao đổi
in exchange 	 trong việc trao đổi về
excite 	 kích thích, kích động
exciting 	 hứng thú, thú vị
excited 	 bị kích thích, bị kích động
excitement 	 sự kích thích, sự kích động
exclude 	ngăn chạn, loại trừ
excluding 	 ngoài ra, trừ ra
excuse 	 lời xin lỗi; xin lỗi
executiven	 sự thi hành;(thuộc)sự thi hành
exercise 	 bài tập; thực hiện
exhibit 	 trưng bày; vật trưng bày
exhibition 	 cuộc triển lãm, trưng bày
exist 	tồn tại, sống
existence 	 sự tồn tại, sự sống
exit 	 lỗi ra, sự đi ra, thoát ra
expand 	 mở rộng, phát triển
expect 	 chờ đợi; liệu trước
expected 	 được chờ đợi, được hy vọng
unexpected 	 bất ngờ, gây ngạc nhiên
unexpectedly 	 bất ngờ, gây ngạc nhiên
expectation 	 sự mong chờ, sự chờ đợi
expense 	chi phí
expensive 	 đắt
experience 	 kinh nghiệm; trải qua
experienced 	có kinh nghiệm, từng trải
experiment 	 cuộc thí nghiệm; thí nghiệm
expert 	 chuyên gia; chuyên môn
explain 	 giải nghĩa, giải thích
explanation 	 sự giải nghĩa, giải thích
explode 	 đập tan (hy vọng...), làm nổ
explore 	 thăm dò, thám hiểm
explosion 	 sự nổ, sự phát triển ồ ạt
export 	 xuất khẩu; hàng xuất khẩu
expose 	trưng bày, phơi bày
express 	 diễn tả; tốc hành
expression 	 sự diễn tả, sự diễn đạt
extend 	giơ (tay, chân..); kéo dài (thời gian
extension 	 sự giơ; sự kéo dài
extensive 	 rộng rãi, bao quát
extent 	 quy mô, phạm vi
extra 	 thêm; thứ thêm
extraordinary 	lạ thường, khác thường
extreme 	 quá khích; sự quá khích
extremely 	 vô cùng, cực độ
eye 	 mắt
face 	 mặt; đối mặt
facility 	 điều kiện dễ dàng, thuận lợi
fact 	việc, sự việc, sự kiện
factor 	 nhân tố
factory 	 nhà máy, xí nghiệp
fail 	 sai, thất bại
failure 	 sự thất bại, người thất bại
faint 	 nhút nhát, yếu ớt
faintly 	 nhút nhát, yếu ớt
fair 	hợp lý, công bằng; thuận lợi
fairly 	 hợp lý, công bằng
unfair 	 không công bằng; bất lợi
unfairly 	 gian lận; bất lợi
faith 	 sự tin tưởng; niềm tin
faithful 	 trung thành, chung thủy
faithfully 	 trung thành, chung thủy
yours faithfully	bạn chân thành
fall 	 rơi, ngã
fall over	ngã lộn nhào, bị đổ
false 	 sai, giả dối
fame 	tên tuổi, danh tiếng
familiar 	 thân thiết, quen thộc
family 	 gia đình, thuộc gia đình
famous 	 nổi tiếng
fan 	người hâm mộ
fancy 	 tưởng tượng, nghĩ rằng
far 	 xa
further 	 xa hơn nữa; thêm nữa
farm 	 trang trại
farming 	 công việc trồng trọt, đồng áng
farmer 	 nông dân, người chủ trại
fashion 	 mốt, thời trang
fashionable 	 đúng mốt, hợp thời trang
fast 	 nhanh
fasten 	 buộc, trói
fat 	 béo; mỡ
father 	 cha (bố)
faucet 	 vòi (ở thùng rượu.........)
fault 	 sự thiết sót, sai sót
favour 	 thiện ý; sự chiếu cố
in favour/favor	ủng hộ cái gì
favourite 	được ưa thích; người (vật) được ưa thích
fear 	sự sợ hãi; lo ngại
feather 	 lông chim
feature 	 điểm đặc trưng; đặc trưng của...
February 	 tháng 2
federal 	 liên bang
fee 	 tiền thù lao, học phí
feed 	 cho ăn, nuôi
feel 	 cảm thấy
feeling 	 sự cảm thấy, cảm giác
fellow 	anh chàng (đang yêu), đồng chí
female 	 thuộc giống cái; giống cái
fence 	hàng rào
festival 	 lễ hội, đại hội liên hoan
fetch 	 tìm về; làm bực mình
fever 	 cơn sốt, bệnh sốt
few 	 ít ỏi; một ít
a few	một ít, một vài
field 	 cánh đồng, bãi chiến trường
fight 	 chiến đấu; cuộc chiến đấu
fighting 	 sự chiến đấu, sự đấu tranh
figure 	 hình dáng; miêu tả
file 	 hồ sơ, tài liệu
fill 	 làm đấy, lấp kín
film 	 phim, được dựng thành phim
final 	 cuối cùng, cuộc đấu chung kết
finally 	cuối cùng, sau cùng
finance 	 tài chính; tài trợ
financial 	 thuộc (tài chính)
find 	 tìm, tìm thấy
find out sth	khám phá, tìm ra
fine 	 tốt, giỏi
finely 	 đẹp đẽ, tế nhị
finger 	 ngón tay
finish 	hoàn thành; sự kết thúc
finished 	 hoàn tất, hoàn thành
fire 	 lửa; đốt cháy
set fire to	đốt cháy cái gì
firm 	 công ty; vũng vàng
firmly 	 vững chắc, kiên quyết
first 	thứ nhất, đầu tiên
at first	trực tiếp
fish 	 con cá; câu cá
fishing 	 sự câu cá, sự đánh cá
fit 	 hợp; thích hợp
fix 	 đóng; sửa chữa
fixed 	đứng yên, bất động
flag 	 quốc kỳ
flame 	 ngọn lửa
flash 	 loé sáng; đèn nháy
flat 	 bằng phẳng; mặt phẳng
flavour 	 mùi vị; cho gia vị
flesh 	 thịt
flight 	 sự bỏ chạy; chuyến bay
float 	 trôi nổi, lơ lửng
flood 	 lũ lụt; tràn đầy
floor 	 sàn, tầng (nhà)
flour 	 bột, bột mỳ
flow 	 sự chảy; chảy
flower 	 bông hoa, cây hoa
flu 	 bệnh cúm
fly 	 sự bay, quãng đường bay
flying 	 biết bay; chuyến bay
focus 	 tập trung; trọng tâm
fold 	 gấp; nếp gấp
folding 	 gấp lại được
follow 	 đi theo sau, tiếp theo
following 	 tiếp theo; theo sau
food 	 đồ ăn, món ăn
foot 	chân, bàn chân
football 	 bóng đá
for 	 cho, dành cho...
force 	 sức mạnh; cưỡng ép
forecast 	 sự dự đoán; dự đoán
foreign 	 nước ngoài, từ nước ngoài
forest 	 rừng
forever 	 mãi mãi
forget 	 quên
forgive 	 tha, tha thứ
fork 	 cái nĩa
form 	 hình dạng; được tạo thành
formal 	 hình thức
formally 	 chính thức
former 	 xưa cũ, nguyên
formerly 	 trước đây, thuở xưa
formula 	 công thức, thể thức
fortune 	 sự giàu có, sự thịnh vượng
forward 	 về tương lai, tiến về phía trước
forward 	 ở phía trước, tiến về phía trước
found 	 tìm, tìm thấy
foundation 	 sự thành lập; tổ chức
frame 	cấu trúc; bố trí
free 	 miễn phí, trả tự do
freely 	 tự do, thoải mái
freedom 	 sự tự do; nền tự do
freeze 	 đóng băng, đông lạnh
frozen 	 lạnh giá
frequent 	 thường xuyên
frequently 	 thường xuyên
fresh 	 tươi, tươi tắn
freshly 	tươi mát, khỏe khoắn
Friday 	fraidi/ thứ Sáu
fridge 	 tủ lạnh
friend 	 người bạn
make friends (with)	kết bạn với
friendly 	 thân thiện, thân mật
unfriendly 	 không thân thiện, không có thiện cảm
friendship 	 tình bạn, tình hữu nghị
frighten 	làm sợ, làm hoảng sợ
frightening 	 kinh khủng, khủng khiếp
frightened 	 hoảng sợ, khiếp sợ
from 	 từ
front 	 mặt; đằng trước
in front (of) 	ở phía trước
freeze 	 sự đông lạnh; làm đóng băng
fruit 	 quả, trái cây
fry 	 chiên rán; thịt rán
fuel 	 chất đốt, nhiên liệu
full	đầy, đầy đủ
fully 	 đầy đủ, hoàn toàn
fun 	 sự vui đùa; hài hước
make fun of	đùa cợt, chế giễu
function 	 chức năng; họat động
fund 	 quỹ; tiền bạc
fundamental 	cơ sở, chủ yếu
funeral 	 lễ tang, đám tang
funny 	 buồn cười, khôi hài
fur 	 bộ da lông thú
furniture 	 đồ đạc (trong nhà)
future 	 tương lai
gain 	 lợi ích; giành được
gallon 	 Galông
gamble 	đánh bạc; cuộc đánh bạc
gambling 	 trò cờ bạc
game 	 trò chơi
gap 	đèo, lỗ hổng; chỗ trống
garage 	 nhà để ô tô
garbage 	 lòng, ruột
garden 	 vườn
gas 	khí, hơi đốt
gasoline 	 dầu hỏa, xăng
gate 	 cổng
gather 	 tập hợp; thu thập
gear 	cơ cấu, thiết bị
general 	 chung chung; tổng
generally 	 nói chung, đại thể
in general	nói chung, đại khái
generate 	 sinh, đẻ ra
generation 	 sự sinh ra; thế hệ
generous 	 rộng lượng, hào phóng
generously 	 rộng lượng, hào phóng
gentle 	 hiền lành, nhẹ nhàng
gently 	 nhẹ nhàng, dịu dàng
gentleman 	 người quý phái, người thượng lưu
genuine 	 thành thật; xác thực
genuinely 	thành thật, chân thật
geography 	địa lý, khoa địa lý
get 	 được, có được
get on	leo, trèo lên
get off	ra khỏi, thoát khỏi
giant 	 người khổng lồ; khổng lồ
gift 	 quà tặng
girl 	 con gái
girlfriend 	 bạn gái, người yêu
give 	 biếu, tặng
give sth away	cho, phát
give sth out	chia, phân phối
give (sth) up	bỏ, từ bỏ
glad 	 vui lòng, sung sướng
glass 	 kính thủy tinh, cái cốc
glasses 	 kính đeo mắt
global 	 toàn cầu
glove 	 bao tay, găng tay
glue 	 keo; gắn lại
gram 	 đậu xanh
go 	 đi
go down	đi xuống
go up	đi lên
be going to	sắp sửa, có ý định
god 	thần, Chúa
gold 	vàng; bằng vàng
good 	 tốt; điều tốt
good at	tiến bộ ở
good for	có lợi cho
goodbye 	tạm biệt; lời chào tạm biệt
goods 	 của cải, hàng hóa
govern 	 cai trị, tcầm quyền
government 	 chính phủ; sự cai trị
governor 	thủ lĩnh; kẻ thống trị
grab 	 túm lấy, chộp lấy
grade 	 điểm số; xếp loại
gradual 	 dần dần, từng bước một
gradually 	 dần dần, từ từ
grain 	 hạt; bản chất
gram 	 ngữ pháp
grammar 	 văn phạm
grand 	 rộng lớn, vĩ đại
grandchild 	 cháu (của ông bà)
granddaughter 	 cháu gái
grandfather 	 ông
grandmother 	 bà
grandparent 	 ông bà
grandson 	 cháu trai
grant 	 cấp phát; sự cấp phát
grass 	 cỏ; đồng cỏ
grateful 	 biết ơn, dễ chịu
grave 	 mộ; trang nghiêm
gray 	 màu xám, hoa râm (tóc)
grey 	 màu xám, hoa râm (tóc)
great 	to lớn, vĩ đại
greatly 	 lắm; cao cả
green 	 xanh lá cây
grocery 	 cửa hàng tạp phẩm
groceries 	 hàng tạp hóa
ground 	 mặt đất, đất, bãi đất
group 	 nhóm
grow 	 mọc, mọc lên
grow up	lớn lên, trưởng thành
growth 	 sự lớn lên, sự phát triển
guarantee 	 bảo lãnh; bảo đảm
guard 	 người bảo vệ; canh giữ
guess 	 phỏng đoán; sự ước chừng
guest 	 khách, khách mời
guide 	 điều chỉ dẫn; dẫn đường
guilty 	 có tội, phạm tội
gun 	 súng
guy 	 bù nhìn, anh chàng
habit 	 thói quen, tập quán
hair 	 tóc
hairdresser 	 thợ làm tóc
half 	 một nửa
hall 	 đại sảnh, hội trường
hammer 	 búa
hand 	 bàn tay; truyền cho
handle 	 cầm; tay cầm
hang 	 treo, mắc
happen 	 xảy ra, xảy đến
happiness 	 sự sung sướng, hạnh phúc
unhappiness 	 nỗi buồn, sự bất hạnh
happy 	 vui sướng, hạnh phúc
happily 	sung sướng, hạnh phúc
unhappy 	 buồn rầu, khốn khổ
hard 	 cứng rắn; hết sức cố gắng
hardly 	 nghiêm khắc, khó khăn
harm 	 thiệt hại; gây thiệt hại
harmful 	 gây tai hại, có hại
harmless 	 không có hại
hat 	cái mũ
hate 	 ghét; lòng căm ghét, thù hận
hatred 	 lòng căm thì, sự căm ghét
have 	 có
have to modal 	 phải (bắt buộc, có bổn phận phải)
he 	 anh ấy, ông ấy
head 	cái đầu (người, thú); chỉ huy
headache 	 chứng nhức đầu
heal 	chữa khỏi, làm lành
health 	 sức khỏe, sự lành mạnh
healthy 	 khỏe mạnh, lành mạnh
hear 	 nghe
hearing 	 sự nghe, thính giác
heart 	 tim, trái tim
heat 	 hơi nóng, sức nóng
heating 	 sự đốt nóng, sự làm nóng
heaven 	 thiên đường
heavy 	 nặng, nặng nề
heavily 	 nặng, nặng nề
heel 	 gót chân
height 	 chiều cao; đỉnh
hell 	 địa ngục
hello 	 xin chào; lời chào
help 	giúp đỡ; sự giúp đỡ
helpful 	 có ích; giúp đỡ
hence 	 kể từ đây; do đó
her 	chị ấy, cô ấy
hers 	cái của cô ấy, cái của chị ấy
here 	 đây, ở đây
hero 	 người anh hùng
herself 	chính cô ta, chính chị ta
hesitate 	 ngập ngừng, do dự
hi 	 xin chào
hide 	 ẩn nấp; che giấu
high 	 cao, ở mức độ cao
highly 	 tốt; ở mức độ cao
highlight 	 làm nổi bật; chỗ nổi bật nhất
highway 	 đường quốc lộ
hill 	đồi
him 	 ông ấy, anh ấy
himself 	 chính ông ta, chính anh ta
hip 	 hông
hire 	 cho thuê (nhà...); sự cho thuê
his 	 của ông ấy, của anh ấy
historical 	 lịch sử, thuộc lịch sử
history 	 lịch sử, sử học
hit 	 đánh đấm; cú đấm
hobby 	 sở thích riêng
hold 	 nắm giữ; sự nắm giữ
hole 	 lỗ trống; hang
holiday 	 ngày lễ, ngày nghỉ
hollow 	 rỗng, trống rỗng
holy 	 linh thiêng; sùng đạo
home 	 nhà; ở tại nhà, nước mình
homework 	bài tập về nhà, công việc làm ở nhà
honest 	 lương thiện, trung thực
honestly 	 lương thiện, trung thực
honour 	danh dự, lòng kính trọng
in honour/honor of	để tỏ lòng tôn kính, trân trọng đối với
hook 	 cái móc; bản lề
hope 	hy vọng; nguồn hy vọng
horizontal 	 (thuộc) chân trời; nằm ngang
horn 	 sừng (trâu, bò...)
horror 	 điều kinh khủng, sự ghê rợn
horse 	 ngựa
hospital 	 bệnh viện, nhà thương
host 	 chủ nhà; dẫn (c.trình)
hot 	 nóng, nóng bức
hotel 	 khách sạn
hour 	 giờ
house 	 căn nhà, toàn nhà
housing 	 nơi ăn chốn ở
household 	 hộ gia đình; (thuộc) gia đình
how 	thế nào, như thế nào, làm sao
however 	 tuy nhiên
huge 	 to lớn, khổng lồ
human 	 (thuộc) con người, loài người
humorous 	 hài hước, hóm hỉnh
humour  	 sự hài hước, sự hóm hỉnh
hungry 	 đói
hunt 	 săn, đi săn
hunting 	 sự đi săn
hurry 	sự vội vàng, sự gấp rút
in a hurry	vội vàng, gấp rút
hurt 	làm bị thương, gây thiệt hại
husband 	 người chồng
ice 	 băng, nước đá
ice cream 	 kem
idea 	 ý tưởng, quan niệm
ideal 	 tư tưởng; lý tưởng
ideally 	lý tưởng, đúng như lý tưởng
identify 	 nhận ra, nhận dạng
identity 	 cá tính; tính đồng nhất
if 	 nếu, nếu như
ignore 	phớt lờ, tỏ ra không biết đến
ill 	 ốm
illegal 	 trái luật, bất hợp pháp
illegally 	 trái luật, bất hợp pháp
illness 	 sự đau yếu, ốm, bệnh tật
illustrate 	 minh họa, làm rõ ý
image 	ảnh, hình ảnh
imaginary 	tưởng tượng, ảo
imagination 	 trí tưởng tượng, sự tưởng tượng
imagine 	 tưởng tượng; tưởng rằng
immediate 	 lập tức, tức thì
immediately 	 ngay lập tức
immoral 	 trái đạo đức; xấu xa
impact 	 sự va chạm, sự tác động
impatient 	 thiếu kiên nhẫn, nóng vội
impatiently 	 nóng lòng, sốt ruột
implication 	 sự lôi kéo, sự liên can
imply 	 ngụ ý, bao hàm
import 	 sự nhập; nhập
importance 	 sự quan trọng, tầm quan trọng
important 	 quan trọng, hệ trọng
importantly 	 quan trọng, trọng yếu
unimportant 	 khônh quan trọng, không trọng đại
impose 	 bắt gánh vác; lợi dụng
impossible 	 không thể làm được, không thể xảy ra
impress 	 khắc ghi; gây ấn tượng
impressed 	được ghi, khắc, in sâu vào
impression 	 ấn tượng; đóng dấu
impressive 	 gấy ấn tượng mạnh; hùng vĩ
improve 	 cải thiện, cái tiến, mở mang
improvement 	 sự cái thiện, sự cải tiến
in 	 trong
inability 	 sự bất lực, bất tài
inch 	insơ (đơn vị đo chiều dài Anh bằng 2,54 cm)
incident 	 việc xảy ra, việc có liên quan
include 	 bao gồm, tính cả
including 	 bao gồm, kể cả
income 	 lợi tức, thu nhập
increase 	 tăng thêm; sựtăng thêm
increasingly 	 tăng thêm
indeed 	 thật vậy, quả thật
independence 	 sự độc lập, nền độc lập
independent 	 độc lập
independently 	 độc lập
index 	 chỉ số, sự biểu thị
indicate 	 cho biết; biểu thị
indication 	 sự biểu thị, sự biểu lộ
indirect 	 gián tiếp
indirectly 	 gián tiếp
individual 	 riêng biệt; cá nhân
indoors 	 ở trong nhà
indoor 	 trong nhà
industrial 	 (thuộc) công nghiệp, kỹ nghệ
industry 	 công nghiệp, kỹ nghệ
inevitable 	 không thể tránh được; vẫn thường thấy
inevitably 	 chắc chắn
infect 	 đầu độc, lan truyền
infected 	 bị nhiễm, bị đầu độc
infection 	 sự nhiễm, sự đầu độc
infectious 	 lây, nhiễm
influence 	 sự ảnh hưởng; ảnh hưởng
inform 	 báo cho biết, cung cấp tin tức
informal 	 không chính thức, không nghi thức
information 	 tin tức, tài liệu, kiến thức
ingredient 	 phần hợp thành, thành phần
initial 	 ban đầu, lúc đầu; chữ đầu (của 1 tên gọi)
initially 	 vào lúc ban đầu, ban đầu
initiative 	 bước đầu, sự khởi đầu
injure 	 làm tổn thương, xúc phạm
injured 	 bị tổn thương, bị xúc phạm
injury 	 sự làm tổn thương; điều tổn hại
ink 	 mực
inner 	 nội bộ; thân cận
innocent 	 trong trắng, ngây thơ
enquiry 	 điều tra, sự thẩm vấn
insect 	 sâu bọ, côn trùng
insert 	 chèn vào, lồng vào
inside 	 mặt trong; nội bộ
insist (on) 	 cứ nhất định, cứ khăng khăng
install 	 đặt (hệ thống máy móc, thiết bị...)
instance 	 ví dụ; trường hợp cá biệt
for instance	ví dụ, chẳng hạn
instead 	 để thay thế
instead of	thay cho
institute 	 viện, học viện
institution 	 sự thành lập; cơ quan
instruction 	 sự dạy, tài liệu cung cấp
instrument 	 dụng cụ âm nhạc khí
insult 	 lăng mạ; lời lăng mạ
insulting 	 lăng mạ, xỉ nhục
insurance 	 sự bảo hiểm
intelligence 	 sự hiểu biết, trí thông minh
intelligent 	 thông minh, sáng trí
intend 	 ý định, có ý định
intended 	 có ý định, có dụng ý
intention 	 ý định, mục đích
interest 	sự thích thú; làm quan tâm
interesting 	 làm thích thú, làm quan tâm
interested 	có thích thú, có chú ý
interior 	 phía trong; ở phía trong
internal 	 ở trong, nội địa
international 	quốc tế
internet 	 liên mạng
interpret 	 giải thích
interpretation 	 sự giải thích
interrupt 	 làm gián đoạn, ngắt lời
interruption 	sự gián đoạn, sự ngắt lời
interval 	khoảng (k-t.gian), khoảng cách
interview 	 cuộc phỏng vấn; phỏng vấn
into 	 vào, vào trong
introduce 	 giới thiệu
introduction 	 sự giới thiệu, lời giới thiệu
invent 	 phát minh, sáng chế
invention 	 sự phát minh, sự sáng chế
invest 	 đầu tư
investigate 	 điều tra, nghiên cứu
investigation 	 sự điều tra, nghiên cứu
investment 	 sự đầu tư, vốn đầu tư
invitation 	 lời mời, sự mời
invite 	 mời
involve 	 bao gồm, thu hút
involved in	để hết tâm trí vào
involvement 	sự bao hàm; dồn hết tâm trí vào
iron 	 sắt; bọc sắt
irritate 	làm phát cáu, chọc tức
irritating 	 làm phát cáu, chọc tức
irritated 	 tức giận, cáu tiết
island 	 hòn đảo
issue 	 sự phát sinh; phát hành
it 	 cái đó, điều đó, con vật đó
its 	của cái đó; cái của điều đó
item 	 tin tức; đồ vật
itself 	 chính cái đó, chính điều đó
jacket 	 áo vét
jam 	 mứt
January 	 tháng giêng
jealous 	ghen,, ghen tị
jeans 	 quần bò, quần zin
jelly 	 thạch
jewellery 	 nữ trang, kim hoàn
job 	 việc, việc làm
join 	 gia nhập; nối
joint 	 chung (giữa 2 người hoặc hơn); đầu nối
jointly 	cùng nhau, cùng chung
joke 	 trò cười; giễu cợt
journalist 	 nhà báo
journey 	 cuộc hành trình (đường bộ); chặng đường đi
joy 	niềm vui, sự vui mừng
judge 	 xét xử; thẩm phán
judgement 	 sự xét xử
juice 	 nước ép (rau, củ, quả)
July 	 tháng 7
jump 	 nhảy; bước nhảy
June 	 tháng 6
junior 	 trẻ hơn; người ít tuổi hơn
just 	 vừa mới, chỉ
justice 	 sự công bằng
justify 	 bào chữa, biện hộ
justified 	 hợp lý, được chứng minh là đúng
keen 	 sắc, bén
keen on	say mê, ưa thích
keep 	 giữ, giữ lại
key 	chìa khóa, thuộc (khóa)
keyboard 	 bàn phím
kick 	 đá; cú đá
kid 	 đứa trẻ
kill 	 giết, tiêu diệt
killing 	 sự giết chóc, sự tàn sát
kilogram  	 Kilôgam
kilometre 	 Kilômet
kind 	loại; tử tế
kindly 	 tử tế, tốt bụng
unkind 	 độc ác, tàn nhẫn
kindness 	 sự tử tế, lòng tốt
king 	vua, quốc vương
kiss 	 hôn, cái hôn
kitchen 	 bếp
knee 	đầu gối
knife 	 con dao
knit 	 đan, thêu
knitted 	 được đan, được thêu
knitting 	 việc đan; hàng dệt kim
knock 	 đánh đập; cú đánh
knot 	 cái nơ; điểm nút
know 	 biết
unknown 	 không biết
well known 	 nổi tiếng, được nhiều người biết đến
knowledge 	 sự hiểu biết, tri thức
litre 	 lít
label 	 nhãn mác; dán nhãn
laboratory	 phòng thí nghiệm
labour 	 lao động; công việc
lack 	 sự thiếu; thiếu
lacking 	 ngu đần, ngây ngô
lady 	 quý bà, quý cô
lake 	 hồ
lamp 	đèn
land 	 đất, đất canh tác, đất đai
landscape 	 phong cảnh
lane 	 đường nhỏ (làng, hẻm phố)
language 	 ngôn ngữ
large 	 rộng, lớn, to
largely 	 phong phú, ở mức độ lớn
last 	 lần cuối; người cuối cùng
late 	 trễ, muộn
later 	 chậm hơn
latest 	 muộn nhất, chậm nhất
latter 	 sau cùng, mới đây
laugh 	 cười; tiếng cười
launch 	 hạ thủy (tàu); khai trương
law 	 luật
lawyer 	 luật sư
lay 	 xếp đặt, bố trí
layer 	 lớp
lazy 	 lười biếng
lead 	 lãnh đạo; sự lãnh đạo
leading 	 lãnh đạo, dẫn đầu
leader 	 người lãnh đạo, lãnh tụ
leaf 	 lá cây
league 	 liên minh, liên hoàn
lean 	 dựa, ỷ vào
learn 	 học, nghiên cứu
least 	 tối thiểu; ít nhất
at least	ít nhất, chí ít
leather 	 da thuộc
leave 	 rời đi, để lại
leave out	bỏ quên, bỏ sót
lecture 	 bài diễn thuyết, bài thuyết trình
left 	bên trái; về phía trái
leg 	 chân (người, thú, bàn...)
legal 	 hợp pháp
legally 	 hợp pháp
lemon 	 quả chanh
lend 	 cho vay, cho mượn
length 	 chiều dài, độ dài
less 	 ít hơn; số lượng ít hơn
lesson 	 bài học
let 	 cho phép, để cho
letter 	 thư; chữ cái, mẫu tự
level 	 trình độ; ngang bằng
library 	 thư viện
licence 	 chứng chỉ; sự cho phép
license 	 cấp chứng chỉ, cho phép
lid 	 nắp; mi mắt (eyelid)
lie 	 nói dối; sự dối trá
life 	 đời, sự sống
lift 	 nhấc lên; sự nhấc lên
light 	ánh sáng; nhẹ nhàng
lightly 	 nhẹ nhàng
like 	 giống như; thích
unlike 	 khác, không giống
likely 	 có khả năng; có thể
unlikely 	 không thể xảy ra, không chắc xảy ra
limit 	 giới hạn, hạn chế
limited 	 hạn chế, có giới hạn
line 	dây, đường
link 	 mắt xích; liên kết
lip 	 môi
liquid 	 chất lỏng; lỏng
list 	 danh sách; ghi vào danh sách
listen (to) 	 nghe, lắng nghe
literature 	 văn chương, văn học
litre 	 lít
little 	 nhỏ bé; một chút
a little 	nhỏ, một ít
live 	 sống, hoạt động
live 	 sống
living 	 sống, đang sống
lively 	 sống, sinh động
load 	 gánh nặng; chất
unload 	 cất gánh nặng, dỡ hàng
loan 	sự vay mượn
local 	 địa phương, cục bộ
locally 	có tính chất địa phương, cục bộ
locate 	 xác định vị trí, định vị
located 	 định vị
location 	 vị trí, sự định vị
lock 	 khóa
logic 	 lô gic
logical 	 hợp lý, hợp logic
lonely 	 cô đơn, bơ vơ
long 	dài, xa; lâu
look 	nhìn; cái nhìn
look after	trông nom, chăm sóc
look at	nhìn, ngắm, xem
look for	tìm kiếm
look forward to	mong đợi cách hân hoan
loose 	 lỏng, không chặt
loosely 	 lỏng lẻo
lord 	Chúa, vua
lorry 	 xe tải
lose 	 mất, thua
lost 	 thua, mất
loss 	 sự mất, sự thua
lot: a lot (of) 	 số lượng lớn; rất nhiều
loud 	 ầm ĩ; to (nói)
loudly 	 ầm ĩ, inh ỏi
love 	 tình yêu; yêu
lovely 	 xinh xắn, có duyên
lover 	 người yêu, người tình
low 	 thấp bé, lùn
loyal 	 trung thành, trung kiên
luck 	 may mắn, vận may
lucky 	 gặp may, hạnh phúc
unlucky 	 không gặp may, bất hạnh
luggage 	 hành lý
lump 	 tảng; cái bướu
lunch 	 bữa ăn trưa
lung 	 phổi
machine 	 máy, máy móc
machinery 	 máy móc, thiết bị
mad 	 điên, mất trí; bực điên người
magazine 	 tạp chí
magic 	 ma thuật; (thuộc) ảo thuật
mail 	 thư từ; gửi qua bưu điện
main 	 chủ yếu, trọng yếu nhất
mainly 	 chính, chủ yếu
maintain 	 giữ gìn, bảo vệ
major 	 lớn, trọng đại
majority 	 phần lớn, đa số
make 	 làm; sự chế tạo
make sth up	làm thành, cấu thành
make-up 	 đồ hóa trang, son phấn
male 	 con trai; đàn ông
mall 	 búa
man 	con người; đàn ông
manage 	quản lý, điều khiển
management 	 sự quản lý, sự điều khiển
manager 	 người quản lý, giám đốc
manner 	kiểu; dáng
manufacturing 	 sự sản xuất, sự chế tạo
manufacturer 	 người chế tạo, người sản xuất
many 	 nhiều
map 	bản đồ
March 	 tháng ba
march 	hành quân; cuộc hành quân
mark 	nhãn mác; đánh dấu
market 	 chợ, thị trường
marketing 	 ma-kết-tinh
marriage 	 sự cưới xin, lễ cưới
marry 	cưới (vợ), lấy (chồng)
married 	 cưới, kết hôn
mass 	 khối lượng; đại chúng
massive 	 to lớn, đồ sộ
master 	 chủ nhân, thạc sĩ
match 	 trận thi đấu; đối chọi
matching 	 tính địch thù, thi đấu
mate 	 bạn nghề; giao phối
material 	 nguyên vật liệu; hữu hình
mathematics 	 toán học, môn toán
matter 	 vật chất; có tính chất quan trọng
maximum 	 tối đa; trị số cực đại
may modal 	 có thể, có lẽ
May 	 tháng 5
maybe 	 có thể, có lẽ
mayor 	 thị trưởng
me 	 tôi, tớ
meal 	 bữa ăn
mean 	 nghĩa, có nghĩa là
meaning 	 ý, ý nghĩa
means 	 của cải; phương tiện
by means of	bằng phương tiện
meanwhile 	 trong lúc đó, trong lúc ấy
measure 	 đo lường; đơn vị đo lường
measurement 	 sự đo lường, phép đo
meat 	 thịt
media 	 phương tiện truyền thông đại chúng
medical 	 (thuộc) y học
medicine 	 y học; thuốc
medium 	 trung bình; sự trung gian
meet 	 gặp, gặp gỡ
meeting 	 cuộc mít tinh, cuộc biểu tình
melt 	tan ra; làm tan chảy ra
member 	 thành viên, hội viên
membership 	tư cách hội viên, địa vị hội viên
memory 	 bộ nhớ, kỉ niệm
in memory of	sự tưởng nhớ
mental 	(thuộc) trí tuệ; mất trí
mentally 	về mặt tinh thần
mention 	nói đến, đề cập
menu 	 thực đơn
mere 	 chỉ là
merely 	 chỉ, đơn thuần
mess 	tình trạng bừa bộn; người nhếch nhác
message 	 tin nhắn, thông điệp
metal 	 kim loại
method 	 phương pháp, cách thức
metre 	 mét
midday 	 trưa, buổi trưa
middle 	 giữa, ở giữa
midnight 	 nửa đêm, 12h đêm
might modal 	 có thể, có lẽ
mild 	êm dịu, ôn hòa
mile 	dặm (đo lường)
military 	 (thuộc) quân đội, quân sự
milk 	 sữa
milligram 	 mi-li-gam
mind 	 trí tuệ; quan tâm
mine 	 của tôi
mineral 	 thợ mỏ; khoáng
minimum 	 tối thiểu; mức tối thiểu
minister 	 bộ trưởng
ministry 	 bộ
minor 	 nhỏ hơn, không quan trọng
minority 	 phần ít, thiểu số
minute 	 phút
mirror 	 gương
miss 	 lỡ; sự thiếu vắng
Miss 	 cô gái, thiếu nữ
missing 	 thiếu vắng, thất lạc
mistake 	 lỗi lầm; phạm lỗi
mistaken 	 sai lầm, hiểu lầm
mix 	 trộn lẫn; sự pha trộn
mixed 	 lẫn lộn, pha trộn
mixture 	 sự pha trộn, sự hỗn hợp
mobile 	 chuyển động, di động
mobile phone	điện thoại đi động
model 	 mẫu, kiểu mẫu
modern 	 hiện đại, tân tiến
mum 	 mẹ
moment 	 chốc, lát
Monday 	 thứ 2
money 	 tiền
monitor 	 lớp trưởng, màn hình máy tính
month 	 tháng
mood 	 lối, thức
moon 	 mặt trăng
moral 	(thuộc) đạo đức; có đạo đức
morally 	 có đạo đức
more 	 hơn, nhiều hơn
moreover 	 hơn nữa, ngoài ra
morning 	 buổi sáng
most 	 nhiều nhất; nhất
mostly 	 hầu hết, chủ yếu là
mother 	 mẹ
motion 	sự chuyển động, sụ di động
motor 	 động cơ mô tô
motorcycle 	 xe mô tô
mount 	 leo trèo; núi
mountain 	 núi
mouse 	 chuột
mouth 	 miệng
move 	 di chuyển; sự di chuyển
moving 	 động, hoạt động
movement 	 sự chuyển động; cử động
movie 	 phim
movie theater 	 rạp chiếu phim
much 	 nhiều, lắm
mud 	 bùn
multiply 	 nhân lên sinh sôi nảy nở
mum 	 mẹ
murder 	tội giết người;, ám sát
muscle 	 cơ, bắp thịt
museum 	 bảo tàng
music 	 nhạc, âm nhạc
musical 	 (thuộc) âm nhạc; du dương
musician 	 nhạc sĩ
must modal 	cần, nên làm
my 	 của tôi
myself 	 tự tôi, chính tôi
mysterious 	 thần bí, huyền bí
mystery 	 điều huyền bí, điều thần bí
nail 	 (tay, chân) móng vuốt
naked 	 khỏa thân, trơ trụi
name 	tên; đặt tên
narrow 	 hẹp, chật hẹp
nation 	 dân tộc, quốc gia
national 	 (thuộc) quốc gia, dân tộc
natural 	 (thuộc) tự nhiên, thiên nhiên
naturally 	 tự nhiên, đương nhiên
nature 	 tự nhiên, thiên nhiên
navy hải quân
near 	 gần; ở gần
nearby 	 gần
nearly 	 gần, sắp, suýt
neat 	ngăn nắp; rành mạch
neatly 	 gọn gàng, ngăn nắp
necessary 	 cần, cần thiết, thiết yếu
necessarily 	 tất yếu, nhất thiết
unnecessary 	 không cần thiết, không mong muốn
neck 	cổ
need 	cần; sự cần
needle 	cái kim, mũi nhọn
negative 	 phủ định
neighbour 	 hàng xóm
neighbourhood 	 khu vực xung quanh, láng giềng
neither 	 không này mà cũng không kia
nephew 	 cháu trai (con anh, chị, em)
nerve 	 thần kinh, can đảm
nervous 	 hoảng sợ, dễ bị kích thích
nervously 	 bồn chồn, lo lắng
nest 	 tổ; làm tổ
net 	 lưới, mạng
network 	 mạng lưới, hệ thống
never 	 không bao giờ, không khi nào
nevertheless 	tuy nhiên, tuy thế mà
new 	mới, mới mẻ, mới lạ
newly 	 mới
news 	 tin, tin tức
newspaper 	 báo
next 	bên cạnh; tiếp nữa
nice 	 thú vị, dễ chịu
nicely 	 thú vị, dễ chịu
niece 	 cháu gái
night 	 đêm, tối
no 	 không
nobody 	không ai, không người nào
noise 	tiếng ồn, sự huyên náo
noisy 	 ồn ào, huyên náo
noisily 	 ồn ào, huyên náo
none 	không ai, không người
nonsense 	 lời nói vô lý, vô nghĩa
nor 	 cũng không
normal 	 bình thường; tình trạng bình thường
normally 	 thông thường, như thường lệ
north 	 phía bắc, phương bắc
northern 	 Bắc
nose 	 mũi
not 	 không
note 	lời ghi chép; ghi chú
nothing 	không gì, không cái gì
notice 	 thông báo; chú ý
take notice of	chú ý
noticeable 	 đáng chú ý, đáng để ý
novel 	tiểu thuyết, truyện
November 	 tháng 11
now 	 bây giờ, hiện giờ, hiện nay
nowhere 	 không nơi nào, không ở đâu
nuclear 	 (thuộc) hạt nhân
number 	 số
nurse 	 y tá
nut 	quả hạch; đầu
obey 	 vâng lời, tuân theo
object 	vật thể; phản đối
objective 	 mục tiêu; (thuộc) mục tiêu
observation 	 sự quan sát, sự theo dõi
observe 	quan sát, theo dõi
obtain 	 đạt được, giành được
obvious 	 rõ ràng, hiển nhiên
obviously 	 một cách rõ ràng, có thể thấy được
occasion 	 dịp, cơ hội
occasionally 	 thỉnh thoảng, đôi khi
occupy 	chiếm lĩnh, chiếm giữ
occupied 	 đang sử dụng, đầy (người)
occur 	 xảy đến, xuất hiện
ocean 	 đại dương
o’clock 	 đúng giờ
October 	 tháng 10
odd 	kỳ cục, lẻ (số)
oddly 	 kỳ cục, lẻ (số)
of 	 của
off 	 tắt; rời
offence 	sự vi phạm, sự phạm tội
offend 	 xúc phạm, làm khó chịu
offensive 	 sự tấn công, cuộc tấn công
offer 	 đề nghị; sự trả giá
office 	 cơ quan, văn phòng, bộ
officer 	 viên chức, cảnh sát, sĩ quan
official 	 (thuộc) chính quyền; viên chức
officially 	 một cách trịnh trọng, một cách chính thức
often 	thường, hay
oh 	 ôi chao
oil 	 dầu
OK 	đồng ý, tán thành
old 	 già
old-fashioned 	 lỗi thời
on 	 ở trên; tiếp tục
once 	 lần; một khi
one number	 một; một người
each other	nhau, lẫn nhau
onion 	 củ hành
only 	 duy nhất; chỉ
onto 	về phía trên, lên trên
open 	 mở; bắt đầu
openly 	 công khai, thẳng thắn
opening 	 khe hở; sự bắt đầu
operate 	 hoạt động, điều khiển
operation 	 sự hoạt động, quá trình hoạt động
opinion 	 ý kiến, quan điểm
opponent 	 đối thủ, kẻ thù
opportunity 	cơ hội, thời cơ
oppose 	 đối kháng; phản đối
opposing 	 tính đối kháng, đối chọi
opposed 	chống lại, phản đối
opposite 	 đối nhau; đối diện
opposition 	 sự đối lập; sự phản đối
option 	 sự lựa chọn
orange 	 quả cam; có màu da cam
order 	 thứ, bậc; ra lệnh
in order to	hợp lệ
ordinary 	 thường, thông thường
organ 	 đàn óoc gan
organization 	 tổ chức; sự tổ chức
organize 	 tổ chức, thiết lập
organized 	 có trật tự, được tổ chức
origin 	nguồn gốc, căn nguyên
original 	 (thuộc) nguồn gốc; nguyên bản
originally 	 một cách sáng tạo; khởi đầu
other 	 khác
otherwise 	 cách khác; nếu không thì…
ought to modal 	hải, hẳn là
our 	 của chúng ta, của chúng tôi
ours 	 của chúng ta, của chúng tôi
ourselves 	 bản thân chúng ta, bản thân chúng
out (of) 	 ở ngoài, ra ngoài
outdoors 	 ở ngoài trời, ở ngoài nhà
outdoor 	 ngoài trời, ở ngoài
outer 	 ở phía ngoài, ở xa hơn
outline 	 phác tảo; đường nét
output 	 sự sản xuất; sản phẩm
outside 	 bề ngoài; ở ngoài;
outstanding 	 nổi bật; còn tồn lại
oven 	lò (nướng)
over 	  vượt qua; lên trên
overall 	 toàn bộ; tất cả
overcome 	 chiến thắng, đánh bại (khó khăn)
owe 	nợ; có được (cái gì)
own 	 của chính mình; nhìn nhận
owner 	 người chủ, chủ nhân
pace 	 bước chân, bước
pack 	 gói, bọc
package 	 gói đồ; đóng gói
packaging 	 bao bì
packet 	 gói nhỏ
page 	 trang (sách)
pain 	sự đau đớn, sự đau khổ
painful 	 đau đớn, đau khổ
paint 	 vôi màu; sơn
painting 	 sự sơn; bức tranh
painter 	 họa sĩ
pair 	đôi, cặp
palace 	 cung điện, lâu đài
pale 	 taí, nhợt
pan 	 xoong, chảo
panel 	ván ô (cửa, tường), pa nô
pants 	 quần lót, đùi
paper 	 giấy
parallel 	 song song, tương đương
parent 	 cha, mẹ
park 	 công viên; khoanh vùng thành công viên
parliament 	 nghi viện, quốc hội
part 	 phần, bộ phận
take part (in)	tham gia (vào)
particular 	 riêng biệt, cá biệt
particularly 	 một cách đặc biệt, riêng biệt
partly 	 đến chừng mực nào đó, phần nào đó
partner 	 đối tác, cộng sự
partnership 	 sự chung phần, sự cộng tác
party 	 buổi liên hoan; đảng
pass 	 qua, vượt qua, ngang qua
passing 	 sự trôi qua; thoáng qua
passage 	 sự trôi qua; hành lang
passenger 	 hành khách
passport 	 hộ chiếu
past 	 quá khứ; qua
path 	đường mòn; hướng đi
patience 	 tính kiên nhẫn, sự chịu đựng
patient 	 bệnh nhân; kiên nhẫn
pattern 	 mẫu, khuôn mẫu
pause 	 tạm dừng; sự tạm ngừng
pay 	thanh toán; tiền lương
payment 	 sự trả tiền, số tiền trả
peace 	 hòa bình, sự hòa thuận
peaceful 	 hòa bình, yên tĩnh
peak 	lưỡi trai; đỉnh
pen 	 bút
pence 	 đồng xu
penny 	 đồng xu
pencil 	 bút chì
penny 	số tiền
pension 	 tiền trợ cấp, lương hưu
people 	 dân tộc; người
pepper 	 hạt tiêu, cây ớt
per 	 cho mỗi
per cent 	 phần trăm
perfect 	 hoàn hảo
perfectly 	 một cách hoàn hảo
perform 	biểu diễn; làm, thực hiện
performance 	 sự biểu diễn
performer 	 người biểu diễn, người trình diễn
perhaps 	 có thể, có lẽ
period	 thời kỳ; thời đại
permanent 	 lâu dài, vĩnh cửu
permanently 	 cách thường xuyên, vĩnh cửu
permission 	 sự cho phép, giấy phép
permit 	 cho phép, cho cơ hội
person 	 con người, người
personal 	 cá nhân, tư, riêng tư
personally 	 đích thân, đối với tôi
personality 	 nhân cách; nhân phẩm
persuade 	 thuyết phục
pet 	cơn nóng giận; vật cưng
petrol 	 xăng dầu
phase 	 tuần trăng; giai đoạn, thời kỳ
philosophy 	 triết học, triết lý
photocopy 	 bản sao chụp; sao chụp
photograph 	 bức ảnh; chụp ảnh
photographer 	 thợ chụp ảnh, nhà nhiếp ảnh
photography 	 thuật chụp ảnh, nghề nhiếp ảnh
phrase 	câu; thành ngữ
physical 	 vật chất; (thuộc) cơ thể
physically 	 về thân thể, theo luật tự nhiên
physics 	 vật lý học
piano 	 đàn pianô, dương cầm
pick 	 cuốc (đất); đào
pick sth up	nhặt cái gì lên
picture 	 bức vẽ, bức họa
piece 	 mẩu; đồng tiền
pig 	 con lợn
pile 	 chồng; chất chồng
pill 	 viên thuốc
pilot 	 phi công
pin 	 đinh ghim; ghim
pink 	 màu hồng; hoa cẩm chướng
pint 	Panh (đơn vị ở Anh bằng 0,58 lít; ở Mỹ bằng 0,473 lít);
pipe 	 ống dẫn (khí, nước...)
pitch 	sân (chơi các môn thể thao); đầu hắc ín
pity 	 lòng thương hại, đáng thương
place 	 địa điểm; quảng trường
take place	xảy ra, được cử hành, được tổ chức
plain 	 ngay thẳng, đơn giản
plan 	 kế hoạch; lập kế hoạch
planning 	 sự lập kế hoạch, sự quy hoạch
plane 	mặt phẳng, mặt bằng
planet 	 hành tinh
plant 	 thực vật; gieo trồng
plastic 	 chất dẻo, làm bằng chất dẻo
plate 	 bản, tấm kim loại
platform 	 bệ; sân ga
play 	 chơi; trò chơi
player 	 người chơi 1 trò chơi nào đó (nhạc cụ)
pleasant 	 dễ thương; dịu dàng
pleasantly 	 dễ thương; thân mật
unpleasant 	 khó chịu, khó ưa
please 	 vừa lòng, mong... vui lòng
pleasing 	 mang lại niềm vui thích; dễ chịu
pleased 	 hài lòng
pleasure 	 điều thích thú; ý thích
plenty 	nhiều; sự phong phú
plot 	 sơ đồ; vẽ sơ đồ
plug 	 nút (thùng, chậu, bồn...)
plus 	cộng với (số, người...); thêm vào
p.m. 	 quá trưa, chiều, tối
pocket 	 túi (quần áo, trong xe hơi), túi tiền
poem 	 bài thơ
poetry 	 thi ca; chất thơ
point 	điểm; chấm (câu..)
pointed 	 nhọn, có đầu nhọn
poison 	 chất độc; tẩm thuốc độc
poisonous 	 có chất độc, gây chết
pole 	người Ba Lan; cực (nam châm, trái đất...)
police 	 cảnh sát, công an
policy 	 chính sách
polish 	 nước bóng; đánh bóng
polite 	 lễ phép, lịch sự
politely 	 lễ phép, lịch sự
political 	 về chính trị, về chính phủ
politically 	 về mặt chính trị; khôn ngoan
politician 	 nhà chính trị, chính khách
politics 	 họat động chính trị, quan điểm chính trị
pollution 	 sự ô nhiễm
pool 	 vũng nước; bể bơi, hồ bơi
poor 	 nghèo
pop 	 phong cách dân gian hiện đại; nổ bốp
popular 	 có tính đại chúng; được nhiều người ưa chuộng
population 	 dân số; mật độ dân số
port 	 cảng
pose 	 đưa ra; sự đặt
position 	 vị trí, chỗ
positive 	 tích cực, lạc quan
possess 	 có, chiếm hữu
possession 	 quyền sở hữu, vật sở hữu
possibility 	 khă năng, triển vọng
possible 	 có thể, có thể thực hiện
possibly 	 có lẽ, có thể chấp nhận được
post 	 bưu kiện; gửi thư
post office 	 bưu điện
pot 	 bình, lọ...
potato 	khoai tây
potential 	 tiềm năng; khả năng
potentially 	 tiềm năng, tiềm ẩn
pound 	pao - đơn vị đo lường
pour 	 rót, đổ
powder 	 bột, bụi
power 	 năng lực; sức mạnh
powerful 	 hùng mạnh, hùng cường
practical 	 thực hành; thực tế
practically 	 về mặt thực hành; thực tế
practice 	thực hành, thực tiễn
practise 	 thực hành, tập luyện
praise 	 sự ca ngợi; khen ngợi
prayer 	 sự cầu nguyện
precise 	 rõ ràng; tỉ mỉ
precisely 	 chính xác, cần thận
predict 	 báo trước, tiên đoán
prefer 	 thích hơn
preference 	 sự ưa hơn; cái được ưa thích hơn
pregnant 	 mang thai; sáng tạo
premises 	 biệt thự
aration 	 sự sửa soạn, sự chuẩn bị
are 	 sửa soạn, chuẩn bị
ared 	 đã được chuẩn bị
presence 	 sự hiện diện; hiện diện
present 	 hiện diện; hiện thời
presentation 	 bài thuyết trình, sự giới thiệu
preserve 	 bảo quản, giữ gìn
president 	 hiệu trưởng, chủ tịnh
press 	 sự ấn; ấn
pressure 	 sức ép, áp lực
presumably 	 có thể được, có lẽ
pretend 	 giả bộ, làm ra vẻ
pretty 	 vừa phải; xinh xắn
prevent 	 ngăn chặn, ngăn ngừa
previous 	 vội vàng; ưu tiên
previously 	 trước, trước đây
price 	giá
pride 	 sự kiêu hãnh; tính kiêu căng
priest 	 linh mục, thầy tu
primary 	 nguyên thủy; tiểu học
primarily 	 trước hết, đầu tiên
prime minister 	 thủ tướng
prince 	hoành tử
princess 	 công chúa
principle 	 nguyên lý, nguyên tắc
print 	in; sự in ra
printing 	 sự in, kỹ sảo in
printer 	 máy in, thợ in
prior 	 trước, ưu tiên
priority 	 sự ưu tế, quyền ưu tiên
prison 	 nhà tù
prisoner 	 tù nhân
private 	 cá nhân, riêng
privately 	 riêng tư, cá nhân
prize 	giải, giải thưởng
probable 	 có thể, có khả năng
probably 	 hầu như chắc chắn
problem 	 vấn đề, điều khó giải quyết
procedure 	 thủ tục
proceed 	 tiến lên, theo duổi, tiếp diễn
process 	 sự tiến triển; chế biến
produce 	 sản xuất, chế tạo
producer 	 nhà sản xuất
product 	 sản phẩm
production 	 sự sản xuất, chế tạo
profession 	nghề, nghề nghiệp
professional 	 (thuộc) nghề; chuyên nghiệp
professor 	 giáo sư, giảng viên
profit 	 lợi ích, lợi nhuận
program 	 chương trình; lên chương trình
programme 	 chương trình
progress 	 sự tiến tới; tiến bộ
project 	đề án; kế hoạch
promise 	hứa, lời hứa
promote 	 thăng chức, thăng cấp
promotion 	 sự thăng chức, sự thăng cấp
prompt 	 nhanh chóng; xúi giục
promptly 	 mau lẹ, ngay lập tức
pronounce 	 thông báo, phát âm
pronunciation 	 sự phát âm
proof 	bằng chứng; sự kiểm chứng
proper 	 thích đáng, thích hợp
properly 	 một cách đúng đắn, một cách thích đáng
property 	 tài sản; đất đai
proportion 	 sự cân xứng, sự cân đối
proposal 	 sự đề nghị, đề xuất
propose 	 đề nghị, đề xuất, đưa ra
prospect 	 viễn cảnh; triển vọng
protect 	 bảo vệ, che chở
protection 	 sự bảo vệ, sự che chở
protest 	 sự phản đối; phản đối
proud 	 tự hào, kiêu hãnh
proudly 	 một cách tự hào, một cách hãnh diện
prove 	 chứng tỏ, chứng minh
provide 	 chuẩn bị đầy đủ; cung cấp
provided 	 với điều kiện là, miễn là
pint 	 panh (= 0, 58 lít (E);=0, 473 lít (A));
publicyhouse	quán rượu, tiệm rượu
public 	 công cộng; công chúng
in public	giữa công chúng, công khai
publicly 	 công khai, công cộng
publication 	 sự công bố; sự xuất bản
publicity 	 sự công khai, sự quảng cáo
publish 	công bố, ban bố; xuất bản
publishing 	 công việc, nghề xuất bản
pull 	 lôi kéo; sự lôi kéo
punch 	 đấm; quả đấm
punish 	phạt, trừng phạt
punishment 	 sự trừng phạt, sự trừng trị
pupil 	 học sinh
purchase 	 sự mua; mua sắm
pure 	 nguyên chất, tinh khiết
purely 	 hoàn toàn, chỉ là
purple 	 có màu tía; màu tía
purpose 	 mục đích, ý định
on purpose	cố tình, cố ý
pursue 	 đuổi theo, đuổi bắt
push 	 xô đẩy; sự xô đẩy
put 	 đặt, cho vào
put sth on	mặc (áo), đội (mũ), đi (giày)
put sth out	tắt, dập tắt
qualification 	 năng lực; khả năng chuyên môn
qualify 	đủ khả năng, đủ điều kiện
qualified 	 đủ tư cách, điều kiện
quality 	 chất lượng, phẩm chất
quantity 	 lượng, số lượng
quarter 	 1/4, 15 phút
queen 	 nữ hoàng
question 	 câu hỏi; chất vấn
quick 	 nhanh
quickly 	 nhanh
quiet 	 yên lặng, yên tĩnh
quietly 	 yên lặng, yên tĩnh
quit 	 thoát, thoát ra
quite 	 hoàn toàn, hầu hết
quote 	 trích dẫn
race 	 chủng; cuộc đua
racing 	 cuộc đua
radio 	 sóng vô tuyến, radio
rail 	 đường ray
railway 	 đường sắt
rain 	 cơn mưa; mưa
raise 	nâng lên, đưa lên
range 	 dãy; trình độ
rank 	 hàng; sắp xếp thành hàng
rapid 	 nhanh, nhanh chóng
rapidly 	 nhanh, nhanh chóng
rare 	 hiếm, ít
rarely 	 hiếm khi, ít khi
rate 	 tỷ lệ, tốc độ
rather 	 thà.. còn hơn, thích... hơn
rather than	hơn là
raw 	tươi sống , còn nguyên chất
reach 	 đi đến, tới
react 	 tác động trở lại, phản ứng
reaction 	 sự phản ứng; sự phản tác dụng
read 	 đọc
reading 	 sự đọc
reader 	 người đọc, độc giả
ready 	 sẵn sàng
real 	thực tế, có thật
really 	 thực ra, thực sự
realistic 	 hiện thực
reality 	sự thật, thực tế
realize 	 thực hiện, thực hành
rear 	 phía sau; ở đằng sau
reason 	 lý do, lý lẽ
reasonable 	 có lý, hợp lý
reasonably 	 hợp lý
unreasonable 	 vô lý
recall 	triệu hồi; gợi lại
receipt 	công thức; đơn thuốc
receive 	 nhận, lĩnh
recent 	 gần đây, mới đây
recently 	 gần đây, mới đây
reception 	 sự tiếp nhận, sự đón tiếp
reckon 	 tính, đếm
recognition 	 sự công nhận, sự thừa nhận
recognize 	 nhận ra; công nhận
recommend 	 giới thiệu; đề nghị
record 	 bản ghi; ghi chép
recording 	 sự ghi, sự thu âm
recover 	 lấy lại, giành lại
red 	 đỏ; màu đỏ
reduce 	 giảm, giảm bớt
reduction 	 sự giảm giá, sự hạ giá
refer to 	tham khảo; nhắc đến
reference 	 sự tham khảo, hỏi ýe kiến
reflect 	 phản hồi, phản ánh
reform 	 cải cách; sự cải cách
refrigerator 	 tủ lạnh
refusal 	 sự từ chối, sự khước từ
refuse 	 từ chối, khước từ
regard 	 đánh giá; cái nhìn
regarding 	 về việc, đối với (vấn đề...)
region 	 vùng, miền
regional 	 vùng, địa phương
register 	 đăng ký; sổ sách
regret 	 đáng tiếc; sự hối tiếc
regular 	 thường xuyên, đều đặn
regularly 	 đều đặn, thường xuyên
regulation 	 điều lệ, quy tắc
reject 	 không chấp nhận, loại bỏ
relate 	 thuật lại; liên hệ
related (to) 	 có liên quan, có quan hệ với
relation 	 mối quan hệ, sự liên quan
relationship 	 mối quan hệ, mối liên lạc
relative 	 có liên quan đến; đại từ quan hệ
relatively 	 có liên quan, có quan hệ
relax 	 giải trí, nghỉ ngơi
relaxed 	 thanh thản, thoải mái
relaxing 	 làm giảm, bớt căng thẳng
release 	 phóng thích; sự giải thoát
relevant 	 thích hợp, có liên quan
relief 	sự giảm nhẹ; sự đền bù
religion 	 tôn giáo
religious 	(thuộc) tôn giáo
rely on 	tin cậy, tin tưởng vào
remain 	 còn lại, vẫn còn như cũ
remaining 	 còn lại
remains 	đồ thừa, cái còn lại
remark 	 sự nhận xét; nhận xét
remarkable 	 đáng chú ý; khác thường
remarkably 	 đáng chú ý; khác thường
remember 	 nhớ, nhớ lại
remind 	 nhắc nhở, gợi nhớ
remote 	 xa xôi, xa cách
removal 	  việc dọn nhà, dời đi
remove 	 dời đi, di chuyển
rent 	 sự thuê mướn; cho thuê
rented 	 được thuê, được mướn
repair 	 sửa chữa; sự sửa chữa
repeat 	 nhắc lại, lặp lại
repeated 	 được nhắc lại, được lặp lại
repeatedly 	 lặp đi lặp lại nhiều lần
replace 	 thay thế
reply 	 sự trả lời; trả lời
report 	 báo cáo; bản báo cáo
represent 	 miêu tả; đại diện
representative 	 điều tiêu, đại diện
reproduce 	 tái sản xuất
reputation 	 sự nổi tiếng, nổi danh
request 	 lời đề nghị; thỉnh cầu
require 	 đòi hỏi, yêu cầu, quy định
requirement 	 nhu cầu; luật lệ
rescue 	giải thoát; sự giải thoát
research 	 sự nghiên cứu
reservation 	 sự hạn chế, điều kiện hạn chế
reserve 	 dự trữ; sự dự trữ
resident 	người sinh sống; cư trú
resist 	chống lại , kháng cự
resistance 	sự chống lại, sự kháng cự
resolve 	quyết định; giải quyết (vấn đề, khó khăn..)
resort 	kế sách, phương kế
resource 	 tài nguyên; thủ đoạn
respect 	 sự kính trọng; tôn trọng
respond 	 hưởng ứng, phản ứng lại
response 	 sự trả lời, sự đáp lại
responsibility 	 trách nhiệm, sự chịu trách nhiệm
responsible 	 chịu trách nhiệm về, chịu trách nhiệm
rest 	 sự nghỉ ngơi; nghỉ ngơi
the rest	cái còn lại, cái khác
restaurant 	 nhà hàng ăn, hiệu ăn
restore 	 hoàn lại; sửa chữa lại
restrict 	 hạn chế, giới hạn
restricted 	 bị hạn chế; vùng cấm
restriction 	sự hạn chế, sự giới hạn
result 	 kết quả; kết quả là...
retain 	 giữ lại, nhớ được
retire 	 rời bỏ; nghỉ việc
retired 	ẩn dật, đã nghỉ việc
retirement 	 sự ẩn dật, sự nghỉ việc
return 	 trở lại; sự trở lại
reveal 	bộc lộ; phát hiện
reverse 	 ngược lại; điều trái ngượci
review 	 sự xem lại; làm lại
revise 	 làm lại
revision 	 sự làm lại
revolution 	 cuộc cách mạng
reward 	 phần thưởng; thưởng công
rhythm 	nhịp điệu
rice 	gạo; cây lúa
rich 	 giàu, giàu có
rid 	 giải thoát (get rid of : tống khứ)
ride 	 cưỡi (ngựa); đường đi
riding 	 môn thể thao cưỡi ngựa, sự đi xe (bus, điện, xe đạp)
rider 	 người cưỡi ngựa, người đi xe đạp
ridiculous 	 buồn cười, lố bịch
right 	phải; ngay thẳng
rightly 	phải, có lý
ring 	 chiếc nhẫn, đeo nhẫn cho ai
rise 	 sự lên; vươn lên
risk 	 mạo hiểm; liều
rival 	 đối thủ; cạnh tranh
river 	 sông
road 	 con đường, đường phố
rob 	 cướp, lấy trộm
rock 	 đá
role 	 vai (diễn), vai trò
roll 	 sự lăn tròn; cuộn
romantic 	 lãng mạn
roof 	 mái nhà, nóc
room 	phòng, buồng
root 	 gốc, rễ
rope 	 dây thừng, xâu chuỗi
rough 	 gồ ghề, lởm chởm
roughly 	 gồ ghề, lởm chởm
round 	 vòng quanh, xung quanh
rounded 	 bị làm thành tròn; phát triển đầy đủ
route 	 đường đi, lộ trình
routine 	 thói thường; thường lệ
row 	hàng, dãy
royal 	(thuộc) hoàng gia
rub 	 cọ xát, xoa bóp
rubber 	 cao su
rubbish 	 bỏ đi, rác rưởi
rude 	bất lịch sự; thô sơ
rudely 	 bất lịch sự; thô sơ
ruin 	 làm hỏng; sự hỏng
ruined 	 bị hỏng, bị phá sản
rule 	 luật lệ; cai trị
ruler 	 người cai trị; thước kẻ
rumour 	 tin đồn, lời đồn
run 	 chạy; sự chạy
running 	sự chạy, cuộc chạy đua
runner 	 người chạy
rural 	 (thuộc) nông thôn, vùng nông thôn
rush 	 xông lên; sự xông lên
sack 	 bao tải; đóng bao
sad 	 buồn, buồn bã
sadly 	 một cách buồn bã, đáng buồn là
sadness 	 sự buồn rầu, sự buồn bã
safe 	 an toàn, đáng tin
safely 	 an toàn, đáng tin
safety 	 sự an toàn, sự chắc chăn
sail 	 đi tàu; chuyến đi bằng thuyền buồm
sailing 	 sự đi thuyền
sailor 	 thủy thủ
salad 	 sa lát (xà lách trộn dầu dấm); rau sống
salary 	 tiền lương
sale 	 việc bán hàng
salt 	 muối
salty 	 có muối, mặn
same 	  đơn điệu; cũng như thế
sample 	 mẫu, hàng mẫu
sand 	 cát
satisfaction 	 sự làm cho thỏa mãn; sự bồi thường
satisfy 	 làm thỏa mãn; trả (nợ)
satisfied 	 cảm thấy hài lòng, thoả mãn
satisfying 	 đem lại sự thỏa mãn, làm vừa ý
Saturday 	 thứ 7
sauce 	 nước xốt, nước chấm
save 	 cứu, lưu
saving 	 sự cứu, sự tiết kiệm
say 	 nói
scale 	 vảy (cá..)
scare 	 làm kinh hãi; sự sợ hãi
scared 	 bị hoảng sợ, bị sợ hãi
scene 	cảnh, phong cảnh
schedule 	 kế hoạch làm việc; lên thời khóa biểu
scheme 	sự sắp xếp; kế hoạch thực hiện
school 	 đàn cá, bầy cá
science 	 khoa học, khoa học tự nhiên
scientific 	 (thuộc) khoa học, có tính khoa học
scientist 	nhà khoa học
scissors 	cái kéo
score 	 điểm số; cho điểm
scratch 	cào; sự trầy xước da
scream 	 gào thét; tiếng thét
screen 	 màn hình; phim ảnh nói chung
screw 	ốc vít; bắt ốc vít
sea 	 biển
seal 	hải cẩu; săn hải cẩu
search 	 sự tìm kiếm; tìm kiếm
season 	 mùa
seat 	ghế, chỗ ngồi
second 	 thứ nhì; người về nhì
secondary 	trung học, thứ yếu
secret 	 bí mật; điều bí mật
secretly 	 bí mật, riêng tư
secretary 	 thư ký
section 	 mục, phần
sector 	 khu vực, lĩnh vực
secure 	 chắc chắn; giữ an ninh
security 	 sự an toàn, sự an ninh
see 	nhìn thấy, quan sát
seed 	 hạt, hạt giống
seek 	 tìm kiếm, theo đuổi
seem linking 	có vẻ như, dường như
select 	 chọn lựa, chọn lọc
selection 	 sự lựa chọn, sự chọc lọc
self 	 bản thân mình
sell 	 bán
senate 	 thượng nghi viện, ban giám hiệu
senator 	 thượng nghị sĩ
send 	 gửi, phái đi
senior 	 nhiều tuổi hơn; người lớn tuổi hơn
sense 	 giác quan, cảm giác
sensible 	 có óc xét đoán; nhận biết được
sensitive 	 dễ bị thương; dễ bị xúc phạm
sentence 	 câu
separate 	 riêng biệt; tách ra
separated 	 ly thân
separately 	 không cùng nhau
separation 	 sự chia cắt, phân ly
September 	 tháng 9
series 	dãy, chuỗi
serious 	 đứng đắn, nghiêm trang
seriously 	 đứng đắn, nghiêm trang
servant 	 người hầu, đầy tớ
serve 	phục vụ, phụng sự
service 	 sự phục vụ, sự hầu hạ
session 	 buổi họp, phiên họp
set 	 đám; bố trí
settle 	 giải quyết, bố trí
several 	 vài
severe 	khắt khe; giản dị
severely 	 khắt khe; giản dị
sew 	may, khâu
sewing 	 sự khâu, sự may vá
sex 	 giới, giống
sexual 	giới tính, các vấn đề sinh lý
sexually 	 giới tính, các vấn đề sinh lý
shade 	bóng, bóng tối
shadow 	 bóng tối, bóng
shake 	 rung lắc; sự rung
shall 	 dự đoán tương lai: sẽ
shallow 	 nông, cạn
shame 	 sự xấu hổ, sự ngượng
shape 	 hình dạng, hình thù
shaped 	 có hình dáng được chỉ rõ
share 	 chia sẻ; phần chia sẻ
sharp 	 sắc nhọn, bén
sharply 	 sắc nhọn, bén
shave 	 cạo (râu), bào
she 	 chị ấy, cô ấy...
sheep 	con cừu
sheet 	 chăn; tờ
shelf 	 ngăn, giá
shell 	 vỏ; vẻ bề ngoài
shelter 	sự nương tựa; che chở
shift 	 đổi chỗ; sự thay đổi
shine 	 chiếu sáng, tỏa sáng
shiny 	 sáng chói, bóng
ship 	tàu, tàu thủy
shirt 	 áo sơ mi
shock 	 sự đụng chạm; chạm mạnh
shocking 	 gây ra căm phẫn, gây kích động
shocked 	 bị kích động, bị sốc
shoe 	 giày
shoot 	 bắn; đâm ra
shooting 	 sự bắn, sự phóng đi
shop 	 cửa hàng; đi mua hàng
shopping 	 sự mua sắm
short 	 ngắn, cụt
shortly 	 trong thời gian ngắn, sớm
shot 	đạn, viên đạn
should modal 	 nên
shoulder 	 vai
shout 	hò hét; sự la hét
show 	 biểu diễn; sự biểu diễn
shower 	vòi hoa sen, sự tắm vòi hoa sen
shut 	 đóng; tính khép kín
shy 	 nhút nhát, e thẹn
sick 	 ốm đau, bệnh
side 	mặt, mặt phẳng
sideways 	 ngang; sang bên
sight 	cảnh đẹp; sự nhìn
sign 	kí hiệu; viết ký hiệu
signal 	 dấu hiệu; báo hiệu
signature 	 chữ ký
significant 	 nhiều ý nghĩa, quan trọng
significantly 	 đáng kể
silence 	sự im lặng, sự yên tĩnh
silent 	 im lặng, yên tĩnh
silk 	tơ ,lụa
silly 	ngớ ngẩn, ngu ngốc
silver 	 bạc; làm bằng bạc
similar 	 giống như, tương tự như
similarly 	 tương tự, giống nhau
simple 	 đơn giản, dễ dàng
simply 	một cách dễ dàng, giản dị
since 	 từ khi; từ lúc ấy
sincere 	 thật thà, thẳng thắng
sincerely 	 một cách chân thành
sing 	 ca hát
singing 	 sự hát, tiếng hát
singer 	 ca sĩ
single 	 đơn, đơn độc, đơn lẻ
sink 	 chìm, đắm
sir 	xưng hô lịch sự Ngài, Ông
sister 	 chị, em gái
sit 	 ngồi
sit down	ngồi xuống
site 	 chỗ, vị trí
situation 	 địa thế, vị trí
size 	 cỡ 
skillful 	 tài giỏi, khéo tay
skillfully 	 tài giỏi, khéo tay
skill 	kỹ năng, kỹ sảo
skilled 	 có kỹ năng; lành nghề
skin 	 da, vỏ
skirt 	 váy, đầm
sky 	trời, bầu trời
sleep 	ngủ; giấc ngủ
sleeve 	tay áo, ống tay
slice 	 lát mỏng; cắt ra thành miếng mỏng
slide 	 chuyển động nhẹ, lướt qua
slight 	 mỏng manh, thon
slightly 	 mảnh khảnh, yếu ớt
slip 	trôi qua, chạy qua
slope 	 độ dốc; dốc
slow 	chậm, chậm chạp
slowly 	 một cách chậm chạp, chậm dần
small 	 nhỏ, bé
smart 	mạnh, ác liệt
smash 	 vỡ tan thành mảnh; sự vỡ tàn thành mảnh
smell 	 ngửi; khứu giác
smile 	 cười; nụ cười
smoke 	 khói; hút thuốc
smoking 	 sự hút thuốc
smooth 	 nhẵn, trơn
smoothly 	 một cách êm ả, trôi chảy
snake 	con rắn; người xảo trá
snow 	 tuyết; tuyết rơi
so 	 như vậy; vì thế
so that	để cho, để mà
soap 	 xà phòng
social 	có tính xã hội
socially 	 có tính xã hội
society 	 xã hội
sock 	 tất ngắn, miếng lót giày
soft 	 mềm, dẻo
softly 	 một cách mềm dẻo
software 	 phần mềm
soil 	đất trồng; vết bẩn
soldier 	 lính, quân nhân
solid 	 thể rắn, chất rắn
solution 	 sự giải quyết, giải pháp
solve 	giải, giải thích, giải quyết
some 	 một ít, một vài
somebody 	 người nào đó
somehow 	 không biết làm sao, bằng cách này hay cách khác
something 	 một điều gì đó
